abuʃan	abușan
adʒud	adjud
afrika	africa
aɡəʃ	agăș
ajud	aiud
alba	alba
aleksandria	alexandria
aleksandru	alexandru
andora	andorra
andreesku	andreescu
anɡelutsə	angheluță
apostolesku	apostolescu
arde̯al	ardeal
ɑrdʒentina	argentina
ardʒeʃ	argeș
b	b
bakəw	bacău
basarabe̯aska	basarabeasca
bejuʃ	beiuș
belize	belize
berlin	berlin
bihor	bihor
bistritsa	bistrița
blaʒ	blaj
boldeʃtj	boldești
botoʃanj	botoșani
brad	brad
braʃov	brașov
breban	breban
britʃenj	briceni
brəila	brăila
bukureʃtj	bucurești
bulɡarja	bulgaria
bulɡaru	bulgaru
buzojanu	buzoianu
buzəw	buzău
bɨrlad	bârlad
bəileʃtj	băilești
bəltsj	bălți
k	c
tʃ	c
sidi	cd
kahul	cahul
kalafat	calafat
karakal	caracal
karansebeʃ	caransebeș
karej	carei
karintia	carintia
karintja	carintia
katalonia	catalonia
kina	china
kiril	chiril
tʃjukə	ciucă
kluʒ	cluj
kodle̯a	codlea
kodoj	codoi
kolteʃtj	coltești
komrat	comrat
konstantsa	constanța
kosteʃtj	costești
kovasna	covasna
krajova	craiova
kristesku	cristescu
kristian	cristian
kristjan	cristian
kriulenj	criuleni
krətʃjun	crăciun
kupidon	cupidon
kɨmpuluŋɡ	câmpulung
kələraʃj	călărași
d	d
datʃia	dacia
deʒ	dej
deva	deva
dionis	dionis
dolʒ	dolj
dorohoj	dorohoi
drokija	drochia
drəɡəʃanj	drăgășani
dud	dud
dɨmbovitsa	dâmbovița
e	e
je	e
edʒipt	egipt
e̞lve̞tsia	elveția
eurovizion	eurovision
f	f
feteʃtj	fetești
fidʒi	fiji
florentsa	florența
floresku	florescu
floreʃtj	florești
fokʃanj	focșani
frunzə	frunză
fəleʃtj	fălești
fəltitʃenj	fălticeni
dʒ	g
ɡ	g
ɡalatsj	galați
dʒe̯ordʒe	george
dʒermania	germania
dʒjurdʒju	giurgiu
ɡlodenj	glodeni
ɡorʒ	gorj
ɡriɡoresku	grigorescu
ɡriɡoriopol	grigoriopol
ɡwatemala	guatemala
h	h
harɡita	harghita
hristos	hristos
hunedo̯ara	hunedoara
huʃj	huși
hɨntʃeʃtj	hîncești
i	i
j	i
j	i
jakobesku	iacobescu
jalomitsa	ialomița
jalovenj	ialoveni
jaʃj	iași
ilfov	ilfov
joan	ioan
islanda	islanda
italia	italia
ʒ	j
ʒak	jac
ʒune	june
k	k
kuvejt	kuweit
l	l
londra	londra
luɡoʒ	lugoj
lupenj	lupeni
ləməʃanu	lămășanu
m	m
mantʃjuria	manciuria
mane̯a	manea
maŋɡalia	mangalia
maramureʃ	maramureș
marɡita	marghita
marsilja	marsilia
meddʒidia	medgidia
medʒidia	medgidia
mediaʃ	mediaș
mehedintsj	mehedinți
mihəjl̪eʃt̪j	mihăilești
mirtʃe̯a	mircea
mojneʃtj	moinești
morenj	moreni
motru	motru
muntenia	muntenia
mureʃ	mureș
mərkuleʃtj	mărculești
ne̯amts	neamț
neɡresku	negrescu
nikolae	nicolae
nikulete	niculete
nistru	nistru
nistrule	nistrule
o	o
olɡa	olga
olt	olt
oltenitsa	oltenița
oltul	oltul
oneʃtj	onești
orade̯a	oradea
orhej	orhei
orəʃtie	orăștie
orʃova	orșova
p	p
pandora	pandora
paʃkanj	pașcani
petroʃanj	petroșani
pjemont	piemont
piteʃtj	pitești
platon	platon
plojeʃtj	ploiești
prahova	prahova
k	q
r	r
raluka	raluca
rezina	rezina
reʃitsa	reșița
roman	roman
romɨnia	românia
romɨnie	românie
romɨniej	româniei
rusia	rusia
rɨʃkanj	rîșcani
rədəutsj	rădăuți
rəzvanj	răzvani
s	s
salonta	salonta
sebeʃ	sebeș
sibiw	sibiu
siɡiʃo̯ara	sighișoara
simionesku	simionescu
siret	siret
slatina	slatina
slobozia	slobozia
s̪or̪oka	soroca
stiria	stiria
stirja	stiria
strəʃenj	strășeni
sutʃe̯ava	suceava
s̪ɨn̪dʒer̪ei	sîngerei
sətʃele	săcele
səlaʒ	sălaj
t	t
taraklia	taraclia
tekutʃj	tecuci
tele̯aʒen	teleajen
teleneʃtj	telenești
teleorman	teleorman
timiʃ	timiș
timiʃo̯arej	timișoarei
t̪ir̪as̪pol̪	tiraspol
toplitsa	toplița
tultʃe̯a	tulcea
turtʃesku	turcescu
turda	turda
tɨrɡoviʃte	târgoviște
tɨrnəvenj	târnăveni
u	u
uɛrɛsɛs	urss
ukraina	ucraina
ukrajna	ucraina
uŋɡenj	ungheni
v	v
vasluj	vaslui
vrantʃe̯a	vrancea
vɨltʃe̯a	vâlcea
u	w
v	w
w	w
wiktsionar	wikționar
ks	x
ɡz	x
iksulesku	xulescu
i	y
j	y
z	z
zaləw	zalău
aba	aba
abak	abac
abatʃe	abace
abadʒerie	abagerie
abadʒiw	abagiu
abaʒur	abajur
abandon	abandon
abandona	abandona
abandonabil	abandonabil
abandonat	abandonat
abandonɨnd	abandonând
abataʒ	abataj
abatesə	abatesă
abaksjal	abaxial
abdika	abdica
abdomen	abdomen
abdominal	abdominal
aberant	aberant
aberativ	aberativ
abia	abia
abja	abia
abilita	abilita
abiotik	abiotic
abʒekt	abject
abneɡatsie	abnegație
abominabil	abominabil
abordaʒ	abordaj
abreviatsie	abreviație
abreviere	abreviere
abrupt	abrupt
absent	absent
apsent	absent
absolut	absolut
apsolut	absolut
absolutist	absolutist
absolutiza	absolutiza
absorbe̯am	absorbeam
absorbit	absorbit
abstrakt	abstract
absurd	absurd
abumarkub	abumarkub
abunda	abunda
abundent	abundent
abur	abur
aburka	aburca
abuz	abuz
abətut	abătut
ak	ac
akademik	academic
akademikə	academică
akaʒu	acaju
akar	acar
akarinatə	acarinată
aktʃe̯a	accea
aktʃede	accede
aktʃedere	accedere
aktʃelera	accelera
aktʃelerasem	accelerasem
aktʃepta	accepta
aktʃesibil	accesibil
aktʃidental	accidental
atʃe̯a	acea
atʃe̯asta	aceasta
atʃastə	această
atʃee̯aʃj	aceeași
atʃejaʃj	aceeași
atʃej	acei
atʃejaʃj	aceiași
atʃel	acel
atʃela	acela
atʃelaʃj	același
atʃele	acele
atʃele̯aʃj	aceleași
atʃelej	acelei
atʃelejaʃj	aceleiași
atʃelor	acelor
atʃeloraʃj	acelorași
atʃeluj	acelui
atʃelujaʃj	aceluiași
atʃera	acera
atʃerə	aceră
atʃest	acest
atʃesta	acesta
atʃeste̯a	acestea
atʃesteja	acesteia
atʃestora	acestora
atʃestuja	acestuia
atʃetil	acetil
atʃetilsalitʃilik	acetilsalicilic
atʃeʃtj	acești
atʃeʃtja	aceștia
akizitsie	achiziție
akizitsionare	achiziționare
atʃi	aci
atʃira	acira
atʃjua	aciua
akoladə	acoladă
akolo	acolo
akoperi	acoperi
akoperit	acoperit
akorda	acorda
akre	acre
akre̯a	acrea
akre̯alə	acreală
akri	acri
akriʃor	acrișor
akru	acru
akt	act
aktiv	activ
aktiva	activa
aktor	actor
aktuar	actuar
akum	acum
akuma	acuma
akumula	acumula
akuza	acuza
akuzat	acuzat
akuzatsie	acuzație
akvatik	acvatic
akvilidə	acvilidă
akətərij	acătării
adaliw	adaliu
adaptabil	adaptabil
adeninə	adenină
adese̯a	adesea
adeseorj	adeseori
adevər	adevăr
adevərat	adevărat
adevərurj	adevăruri
adia	adia
adiktiv	adictiv
adiktsije	adicție
adine̯aurj	adineauri
adio	adio
adʒektival	adjectival
adʒudeka	adjudeca
administra	administra
administrativ	administrativ
administrato̯are	administratoare
administrator	administrator
administratsie	administrație
administratsiː	administrații
admira	admira
admiratsie	admirație
admisibil	admisibil
adnota	adnota
adopta	adopta
adora	adora
adorabil	adorabil
adorator	adorator
adoratsie	adorație
adormit	adormit
adutʃe	aduce
adukt	aduct
adukəto̯are	aducătoare
adular	adular
adulmeka	adulmeca
adult	adult
adulte	adulte
adultera	adultera
aduna	aduna
adunətor	adunător
adverb	adverb
adverbial	adverbial
adɨŋk	adânc
adɨntʃi	adânci
adɨntʃj	adânci
adəpa	adăpa
adəpostit	adăpostit
adəsta	adăsta
adəuɡa	adăuga
aera	aera
afatʃere	afacere
afemejat	afemeiat
aferim	aferim
afiʃa	afișa
afiʃabil	afișabil
afiʃaʒ	afișaj
afla	afla
afront	afront
afuma	afuma
afund	afund
afunda	afunda
afurisit	afurisit
afɨna	afâna
aɡat	agat
adʒente	agente
adʒer	ager
adʒita	agita
aɡlomerat	aglomerat
aɡlomeratsie	aglomerație
aɡrafə	agrafă
aɡrava	agrava
aɡresiv	agresiv
aɡrikol	agricol
aɡrikultor	agricultor
aɡrimensor	agrimensor
aɡriʃə	agrișă
aɡronom	agronom
aɡronoma	agronoma
aɡronomə	agronomă
aɡura	agura
aɡuridə	aguridă
aɡust	agust
aɡətsa	agăța
aɡətsat	agățat
aj	ai
aja	aia
aitʃa	aicea
aidoma	aidoma
ajepta	aiepta
ajest	aiest
ajeve̯a	aievea
ajor	aior
ajsberɡ	aisberg
ajura	aiura
ajure̯a	aiurea
ajurit	aiurit
aʒuna	ajuna
aʒundʒe	ajunge
aʒuta	ajuta
aʒutətor	ajutător
al	al
alamə	alamă
alarma	alarma
alb	alb
alba	alba
albastru	albastru
albatros	albatros
albe	albe
albe̯a	albea
albedo	albedo
albi	albi
albj	albi
albitʃjos	albicios
albinar	albinar
albinos	albinos
albinə	albină
albinərel	albinărel
albuʃ	albuș
albə	albă
albəstre̯a	albăstrea
albəstrele	albăstrele
albəstri	albăstri
albəstriw	albăstriu
albəstruj	albăstrui
alcimik	alchimic
alkoolik	alcoolic
alkolikə	alcoolică
alkoolikə	alcoolică
ale	ale
ale̯a	alea
aleatorju	aleatoriu
alee	alee
aleɡa	alega
aledʒe	alege
aledʒe̯am	alegeam
aleɡətor	alegător
alej	alei
alene	alene
alerɡa	alerga
alerɡat	alergat
alfabet	alfabet
alfabetiza	alfabetiza
alfabetu	alfabetul
alfabetul	alfabetul
aldʒebrik	algebric
alɡoritm	algoritm
alɡə	algă
aliat	aliat
aliment	aliment
alimentarə	alimentară
alina	alina
alinta	alinta
aljo	alio
alivankə	alivancă
alo	alo
alodʒik	alogic
alotropik	alotropic
alpaka	alpaca
alt	alt
altar	altar
alttʃeva	altceva
alttʃineva	altcineva
altkumva	altcumva
altkɨndva	altcândva
altera	altera
altminterj	altminteri
altoi	altoi
altoj	altoi
altundeva	altundeva
altə	altă
altədatə	altădată
aluminifer	aluminifer
aluminju	aluminiu
alunar	alunar
aluneka	aluneca
alunekos	alunecos
alunɡa	alunga
alundʒi	alungi
alurə	alură
aləmoʒnə	alămojnă
aləpta	alăpta
alətura	alătura
altsij	alții
am	am
amabil	amabil
amabile	amabile
amabilj	amabili
amalɡam	amalgam
amaneta	amaneta
amar	amar
amara	amara
amarilis	amarilis
amarilisu	amarilisul
amarilisul	amarilisul
ambala	ambala
ambalaʒ	ambalaj
ambalaʒe	ambalaje
ambalare	ambalare
ambalərj	ambalări
ambasadə	ambasadă
ambij	ambii
ambitsie	ambiție
amenintsa	amenința
amenintsətor	amenințător
amerikan	american
amerikaŋkə	americancă
amerikanj	americani
amerikanə	americană
amesteka	amesteca
amestekat	amestecat
ametist	ametist
ametse̯alə	amețeală
ametsi	ameți
ametsit	amețit
ametsitor	amețitor
amfibian	amfibian
amfibjan	amfibian
amfibju	amfibiu
amfite̯atru	amfiteatru
amfitrion	amfitrion
amjazi	amiazi
amjazə	amiază
amik	amic
amikal	amical
amikale	amicale
amitʃitsie	amiciție
amikə	amică
amidon	amidon
aminte̯askə	amintească
amintesk	amintesc
aminti	aminti
amnar	amnar
amor	amor
ampulə	ampulă
amuza	amuza
amvon	amvon
amɨna	amâna
amənuntsit	amănunțit
aməre̯alə	amăreală
aməruj	amărui
amərɨt	amărât
amərətʃjos	amărăcios
an	an
anakruzə	anacruză
anaɡodʒik	anagogic
analist	analist
analistə	analistă
analoɡ	analog
analodʒik	analogic
ananas	ananas
anapest	anapest
anarhik	anarhic
anatide	anatide
anatomia	anatomia
anatomik	anatomic
anatomist	anatomist
anketə	anchetă
andoran	andorran
andre̯a	andrea
anekdotik	anecdotic
aneksa	anexa
anɡilə	anghilă
aŋɡlikan	anglican
aŋɡlofon	anglofon
anij	anii
anima	anima
animal	animal
animalə	animală
animato̯are	animatoare
animator	animator
animatsie	animație
anormal	anormal
anotimp	anotimp
ansamblu	ansamblu
anterior	anterior
antik	antic
antiɡuan	antiguan
antilopə	antilopă
antisotʃial	antisocial
antiviral	antiviral
antiɨmbətrɨnire	antiîmbătrânire
antrenare	antrenare
antropoloɡ	antropolog
antropoloɡə	antropologă
anual	anual
anulare	anulare
anulat	anulat
anulərj	anulări
anumit	anumit
anusu	anusul
anusul	anusul
aoleo̯	aoleo
aolew	aoleu
aparat	aparat
aparitsie	apariție
apartament	apartament
apatit	apatit
apatrid	apatrid
apikulto̯are	apicultoare
apikultor	apicultor
aplikatsie	aplicație
apokalipsu	apocalipsul
apokalipsul	apocalipsul
apokaliptiku	apocalipticul
apokaliptikul	apocalipticul
apoj	apoi
apos	apos
apriɡ	aprig
aprilije	aprilie
aprins	aprins
apropo	apropo
apuka	apuca
apus	apus
apə	apă
apərəto̯are	apărătoare
apətos	apătos
ara	ara
arab	arab
arabik	arabic
arabil	arabil
araɡonit	aragonit
arahide	arahide
arahidə	arahidă
arahnidə	arahnidă
aramə	aramă
aranʒa	aranja
aratru	aratru
arbitrar	arbitrar
arbora	arbora
aɾbore	arbore
arborikulto̯are	arboricultoare
arborikultor	arboricultor
arkaʃ	arcaș
arkuʃ	arcuș
arde	arde
are	are
arete	arete
ardʒilos	argilos
ardʒint	argint
ardʒintie	argintie
ardʒintij	argintii
arɡon	argon
arheoloɡ	arheolog
arheoloɡə	arheologă
arhikunoskut	arhicunoscut
arhitekt	arhitect
arhitektə	arhitectă
arhivar	arhivar
arhivist	arhivist
arinos	arinos
aripə	aripă
aritmetik	aritmetic
armadə	armadă
armat	armat
armator	armator
arme̯an	armean
arme̯aŋkə	armeancă
arme̯anə	armeană
armoniza	armoniza
armurier	armurier
arməsaru	armăsarul
arməsarul	armăsarul
aroɡant	arogant
arpadʒik	arpagic
ars	ars
arsen	arsen
artistik	artistic
artroɡramə	artrogramă
arəmiw	arămiu
arətor	arător
arətos	arătos
astʃensor	ascensor
askultətor	ascultător
askunde	ascunde
askunzəto̯are	ascunzătoare
askutsit	ascuțit
askutsito̯are	ascuțitoare
asemene̯a	asemenea
asemənare	asemănare
asemənətor	asemănător
asiɡura	asigura
asistat	asistat
aspirator	aspirator
aspiratsie	aspirație
asprete	asprete
aspru	aspru
aste̯a	astea
astmatik	astmatic
astmə	astmă
astrobioloɡ	astrobiolog
astrobioloɡə	astrobiologă
astrofizitʃian	astrofizician
astrofizitʃianə	astrofiziciană
astrolab	astrolab
astronaut	astronaut
astronautə	astronaută
astronom	astronom
astronomə	astronomă
astruka	astruca
astupa	astupa
astəzj	astăzi
atakant	atacant
atare	atare
atent	atent
atew	ateu
atindʒe	atinge
atlantik	atlantic
atom	atom
atotputernik	atotputernic
atotvəzətor	atotvăzător
atotʃtiutor	atotștiutor
atradʒe	atrage
atrəɡətor	atrăgător
atrəsej	atrăsei
atuntʃj	atunci
atɨt	atât
atɨta	atâta
atɨte̯a	atâtea
atɨtsja	atâția
aw	au
audiovizual	audiovizual
awɡit	augit
awɡur	augur
awɡust	august
aur	aur
auriw	auriu
australian	australian
awtobuz	autobuz
autohton	autohton
automat	automat
automate	automate
automatə	automată
autor	autor
auʃ	auș
auʃel	aușel
avantaʒos	avantajos
avaria	avaria
ave̯a	avea
aventura	aventura
avere	avere
avertiza	avertiza
aviato̯are	aviatoare
aviator	aviator
avjon	avion
aviva	aviva
avizo	avizo
avokat	avocat
avokatə	avocată
avut	avut
avɨnta	avânta
azj	azi
azot	azot
azotos	azotos
azur	azur
azurit	azurit
azuritə	azurită
aʃ	aș
aʃa	așa
aʃeza	așeza
aʃezə	așeză
b	b
baban	baban
babaw	babau
babawa	babaua
batʃj	baci
bakə	bacă
baɡatel	bagatel
baɡateliza	bagateliza
baɡdadie	bagdadie
baɡə	bagă
bajram	bairam
balkon	balcon
bale	bale
balenə	balenă
balerinə	balerină
baletistə	baletistă
balsam	balsam
balə	bală
ban	ban
bananə	banană
banknotə	bancnotă
bankrutə	bancrută
banj	bani
barabulə	barabulă
baraʒ	baraj
barbə	barbă
barman	barman
barmanitsə	barmaniță
barz	barz
barzə	barză
basketbal	baschetbal
baskə	bască
basm	basm
batat	batat
bate	bate
batist	batist
bato̯ane	batoane
baton	baton
be̯a	bea
be̯aw	beau
bebe	bebe
bip	beep
beʒ	bej
beltʃjuɡ	belciug
belenɡer	belengher
benefik	benefic
beŋɡal	bengal
benzinərie	benzinărie
bere	bere
beriliw	beriliu
berərie	berărie
bete	bete
bete̯aɡ	beteag
beteʒi	beteji
bezmetik	bezmetic
beznə	beznă
betsivan	bețivan
bianual	bianual
bjatə	biată
biban	biban
bibilikə	bibilică
biblie	biblie
bibliotekar	bibliotecar
bibliotekə	bibliotecă
bitʃikletə	bicicletă
biklə	biclă
bidew	bideu
bjet	biet
bjete	biete
bjetsj	bieți
bilet	bilet
binar	binar
bine	bine
binekuvɨntare	binecuvântare
binefatʃere	binefacere
binefəkətor	binefăcător
binevoi	binevoi
bineɨntseles	bineînțeles
biocimik	biochimic
biokimist	biochimist
biokimistə	biochimistă
bioloɡ	biolog
biolodʒik	biologic
biolodʒie	biologie
bioloɡə	biologă
biotik	biotic
bioksid	bioxid
birman	birman
birow	birou
biruintsə	biruință
biseritʃesk	bisericesc
biserikos	bisericos
biserikutsə	bisericuță
biseksual	bisexual
bismut	bismut
bitumen	bitumen
bituminos	bituminos
bivalent	bivalent
bizon	bizon
blaʒin	blajin
blaʒinətate	blajinătate
blanə	blană
blasfema	blasfema
blasfemie	blasfemie
bleɡ	bleg
blestemat	blestemat
blø	bleu
blok	bloc
bloka	bloca
blokadə	blocadă
bloɡər	blogger
blond	blond
blɨnd	blând
blɨndiʃor	blândișor
blənar	blănar
blənəre̯asə	blănăreasă
bo̯atʃe	boace
bo̯akənə	boacănă
bo̯ala	boala
bobok	boboc
boktʃe̯a	boccea
boem	boem
boɡat	bogat
boj	boi
boja	boia
bojeri	boieri
bojerj	boieri
bolivian	bolivian
bolnav	bolnav
bolnəvjor	bolnăvior
bolɨnd	bolând
bomba	bomba
bombardament	bombardament
bombo̯anə	bomboană
bombə	bombă
bomfajer	bomfaier
bont	bont
bor	bor
borkan	borcan
bortə	bortă
bortso̯asə	borțoasă
bortsos	borțos
bosket	boschet
bos	boss
bosumfla	bosumfla
bosumflat	bosumflat
botanik	botanic
botanikə	botanică
botanist	botanist
botanistə	botanistă
botezat	botezat
botɡros	botgros
botroʃ	botroș
bow	bou
bovin	bovin
boks	box
bokser	boxer
boʃoroɡ	boșorog
braŋkardier	brancardier
brav	brav
brats	braț
bre	bre
bre̯abən	breabăn
brebene̯a	brebenea
brebenel	brebenel
breton	breton
britʃj	brici
bri	brie
brifiŋɡ	briefing
briɡadier	brigadier
britanik	britanic
britanitʃj	britanici
brom	brom
bronz	bronz
brumar	brumar
brumə	brumă
brumərel	brumărel
bruməriw	brumăriu
brun	brun
bruna	bruna
brune	brune
brunj	bruni
brusk	brusc
brutal	brutal
brɨnzə	brânză
brɨw	brâu
brəbin	brăbin
brədio̯arə	brădioară
bubuiturə	bubuitură
bukatə	bucată
butʃile	bucile
bukureʃte̯an	bucureștean
bukureʃtenj	bucureșteni
bukurie	bucurie
bukuros	bucuros
bukətərije	bucătărie
bukətse̯a	bucățea
bukətsi	bucăți
bukətsj	bucăți
buda	buda
budism	budism
bufal	bufal
bufnitsə	bufniță
bufnə	bufnă
bufon	bufon
budʒed	buged
buhaj	buhai
bujestru	buiestru
buʒor	bujor
bulandʒiw	bulangiu
bulevard	bulevard
bulɡare	bulgare
bun	bun
bundʒet	bunget
bunj	buni
bunitʃel	bunicel
bunikuts	bunicuț
bunikutsə	bunicuță
bunikə	bunică
buniʃor	bunișor
bunurj	bunuri
bunuts	bunuț
bunəvointsə	bunăvoință
bura	bura
burɡiw	burghiu
burlak	burlac
burtos	burtos
burə	bură
buzə	buză
bajt	byte
bajtsj	byți
bɨʒbɨi	bâjbâi
bɨrloɡ	bârlog
bɨtlan	bâtlan
bə	bă
bədəran	bădăran
bəɡərets	băgăreț
bəj	băi
bəjetsaʃu	băiețașul
bəjetsaʃul	băiețașul
bəjetsej	băieței
bəjetseij	băiețeii
bəjetselu	băiețelul
bəjetselul	băiețelul
bəl	băl
bəlaj	bălai
bəlan	bălan
bəlbəw	bălbău
bəlməʒe̯alə	bălmăjeală
bəlos	bălos
bəltos	băltos
bəltəw	băltău
bələjor	bălăior
bəltsat	bălțat
bənui	bănui
bənujalə	bănuială
bərbat	bărbat
bərbatsj	bărbați
bərbos	bărbos
bərbəte̯askə	bărbătească
bərbətesk	bărbătesc
bərbətos	bărbătos
bərbətuʃ	bărbătuș
bətaje	bătaie
bətrɨn	bătrân
bətrɨnet	bătrânet
bətrɨnə	bătrână
bətut	bătut
bəubil	băubil
bəut	băut
bəutor	băutor
bəuturə	băutură
k	c
tʃ	c
ka	ca
kabanier	cabanier
kabanə	cabană
kakolodʒie	cacologie
kad	cad
kadavru	cadavrul
kadavrul	cadavrul
kado	cado
kadow	cadou
kadru	cadru
kafe̯a	cafea
kafene̯a	cafenea
kafeniw	cafeniu
kaj	cai
kajman	caiman
kal	cal
kalamar	calamar
kalambur	calambur
kalkan	calcan
kalkar	calcar
kalkare	calcare
kalkaros	calcaros
kaltʃit	calcit
kaltʃju	calciu
kalkul	calcul
kalkulat	calculat
kald	cald
kalde	calde
kaldə	caldă
kale	cale
kalifika	califica
kalifikat	calificat
kaliɡrafie	caligrafie
kalitətsj	calități
kalmar	calmar
kalotə	calotă
kalzj	calzi
kameraman	cameraman
kamerə	cameră
kempinɡ	camping
kanal	canal
kanar	canar
kaŋɡur	cangur
kanibal	canibal
kanibalə	canibală
kanikular	canicular
kanikulə	caniculă
kantata	cantata
kantautor	cantautor
kantinier	cantinier
kanton	canton
kap	cap
kapabil	capabil
kapak	capac
kapital	capital
kapitalist	capitalist
kapitalə	capitală
kapitol	capitol
kaprin	caprin
kaprinə	caprină
kaprə	capră
karakara	caracara
karakteristitʃj	caracteristici
karakteristikə	caracteristică
karameliza	carameliza
karantinə	carantină
karbon	carbon
karbonat	carbonat
karboksilik	carboxilic
kartʃinom	carcinom
kardinal	cardinal
kardinalj	cardinali
kardioloɡ	cardiolog
kardioloɡə	cardiologă
kare	care
karikaturist	caricaturist
karikaturistə	caricaturistă
karne	carne
karnivor	carnivor
karte	carte
karte̯a	cartea
kartezian	cartezian
kartof	cartof
kartoɡraf	cartograf
kartomantsie	cartomanție
kaskador	cascador
kaskadə	cascadă
kasnik	casnic
kast	cast
kastaniw	castaniu
kastel	castel
kastra	castra
kastravete	castravete
katalan	catalan
katalanə	catalană
katapulta	catapulta
katastrofik	catastrofic
katehiza	catehiza
katerisi	caterisi
katife̯a	catifea
katifelat	catifelat
katran	catran
katren	catren
kaute	caute
kauzə	cauză
kau̯zə	cauză
kaval	caval
kaviar	caviar
kazuar	cazuar
kazuistik	cazuistic
kaʃ	caș
kaʃalot	cașalot
kaʃkaval	cașcaval
kaʃə	cașă
katsə	cață
tʃe	ce
tʃe̯a	cea
tʃe̯akɨr	ceacâr
tʃe̯air	ceair
tʃe̯apə	ceapă
tʃe̯arə	ceară
tʃe̯as	ceas
tʃe̯aʃkə	ceașcă
tʃe̯atsə	ceață
tʃetʃen	cecen
tʃee̯a	ceea
tʃeh	ceh
tʃehj	cehi
tʃej	cei
tʃele	cele
tʃelebɾa	celebra
tʃelebru	celebru
tʃeliakie	celiachie
tʃelt	celt
tʃelulə	celulă
tʃeləlalt	celălalt
tʃeltsj	celți
tʃentralj	centrali
tʃenuʃiw	cenușiu
tʃer	cer
tʃeramik	ceramic
tʃeramistə	ceramistă
tʃerka	cerca
tʃertʃel	cercel
tʃertʃetətor	cercetător
tʃere	cere
tʃere̯askə	cerească
tʃeresk	ceresc
tʃereʃtj	cerești
tʃerne̯alə	cerneală
tʃeros	ceros
tʃert	cert
tʃerʃetorie	cerșetorie
tʃetate	cetate
tʃeʃtj	cești
tʃetsos	cețos
kefal	chefal
keja	cheia
kel	chel
keltui	cheltui
kema	chema
kemare	chemare
kemat	chemat
kemətor	chemător
kenar	chenar
kepenɡ	chepeng
kestie	chestie
kjar	chiar
kibzui	chibzui
kibzuintsə	chibzuință
kibzuit	chibzuit
kihlimbar	chihlimbar
cimik	chimic
kimion	chimion
kimist	chimist
kimistə	chimistă
kin	chin
kinez	chinez
kinezj	chinezi
kinezo̯ajtʃe	chinezoaice
kinezo̯ajkə	chinezoaică
kinezə	chineză
kinui	chinui
kinuitor	chinuitor
kiot	chiot
kip	chip
tʃips	chips
kir	chir
kiromant	chiromant
kitarə	chitară
kjuli	chiuli
kitskan	chițcan
kristadelfian	christadelfian
tʃi	ci
tʃau	ciao
tʃiklist	ciclist
tʃiklistə	ciclistă
tʃiklon	ciclon
tʃiklostom	ciclostom
tʃikəle̯alə	cicăleală
tʃimbru	cimbru
tʃintʃe̯a	cincea
tʃintʃj	cinci
tʃintʃile̯a	cincilea
tʃintʃime	cincime
tʃinsprezetʃe	cincisprezece
tʃintʃjsprezetʃe	cincisprezece
tʃinsprezetʃe̯a	cincisprezecea
tʃintʃjsprezetʃe̯a	cincisprezecea
tʃinsprezetʃele̯a	cincisprezecelea
tʃintʃjsprezetʃele̯a	cincisprezecelea
tʃintʃjzetʃe̯a	cincizecea
tʃinzetʃe̯a	cincizecea
tʃintʃjzetʃj	cincizeci
tʃinzetʃj	cincizeci
tʃintʃjzetʃile̯a	cincizecilea
tʃinzetʃile̯a	cincizecilea
tʃine	cine
tʃinetik	cinetic
tʃineva	cineva
tʃinɡəto̯are	cingătoare
tʃinstit	cinstit
tʃintezə	cinteză
tʃinzetʃj	cinzeci
tʃinʃpe	cinșpe
tʃinʃpe̯a	cinșpea
tʃinʃpele̯a	cinșpelea
tʃjo̯akə	cioacă
tʃo̯aretʃj	cioareci
tʃo̯arə	cioară
tʃoban	cioban
tʃjobanj	ciobani
tʃjok	cioc
tʃjokolate	ciocolate
tʃjokɨrlan	ciocârlan
tʃjokɨrlie	ciocârlie
tʃjokənito̯are	ciocănitoare
tʃoɾap	ciorap
tʃirak	cirac
tʃirkuit	circuit
tʃirkular	circular
tʃirkularə	circulară
tʃirkumtʃise	circumcise
tʃirkumfleks	circumflex
tʃirkumskrie	circumscrie
tʃire̯aʃə	cireașă
tʃireʃar	cireșar
tʃitets	citeț
tʃitire	citire
tʃitito̯are	cititoare
tʃititor	cititor
tʃitrin	citrin
tʃubər	ciubăr
tʃufuli	ciufuli
tʃufulit	ciufulit
tʃjufut	ciufut
tʃjut	ciut
tʃjutə	ciută
tʃiviliza	civiliza
tʃivilizatsie	civilizație
klantsə	clanță
klapon	clapon
klarj	clari
klasə	clasă
klavetʃin	clavecin
klimatoloɡ	climatolog
klimatoloɡə	climatologă
klinti	clinti
klip	clip
klipej	clipei
klipitə	clipită
klor	clor
kloroform	cloroform
kləntsəw	clănțău
kne̯az	cneaz
ko̯atʃin	coacin
ko̯afor	coafor
ko̯aje	coaie
ko̯aʒə	coajă
ko̯apsə	coapsă
ko̯arnə	coarnă
ko̯ase	coase
kobaj	cobai
kobalt	cobalt
koborɨt	coborât
koborɨ	coborî
kobzə	cobză
kok	coc
kocet	cochet
kokilie	cochilie
koklaurj	coclauri
kokor	cocor
kokos	cocos
kokoʃat	cocoșat
kokoʃatsj	cocoșați
kodalb	codalb
kodalbj	codalbi
kodaʃ	codaș
kodifikat	codificat
kodiriʃte	codiriște
kodirlə	codirlă
kodobaturə	codobatură
kodru	codru
kodrule	codrule
kodɨrlə	codârlă
kofraʒ	cofraj
koʒj	coji
kolaborator	colaborator
kolektatsj	colectați
kolibri	colibri
kolibə	colibă
kolokatsie	colocație
kolofon	colofon
kolorat	colorat
kolətʃel	colăcel
koltsun	colțun
komandant	comandant
kombate	combate
kombinat	combinat
kombinatsie	combinație
komerts	comerț
komestibil	comestibil
komo̯arə	comoară
komorian	comorian
komparatsie	comparație
kompensatsie	compensație
kompetent	competent
kompetentsə	competență
kompetitsie	competiție
komplet	complet
kompleta	completa
komplitʃe	complice
komplimenta	complimenta
komponent	component
komponentə	componentă
komporta	comporta
kompozitsie	compoziție
kompus	compus
komune	comune
komunikatsie	comunicație
komunism	comunism
komuniune	comuniune
komunə	comună
kontʃentrat	concentrat
konklude	conclude
konkordantsə	concordanță
konkret	concret
konditsie	condiție
kondor	condor
kondutʃe	conduce
kondutʃere	conducere
konfiɡurare	configurare
konfirma	confirma
konform	conform
konfuz	confuz
konʒuɡa	conjuga
konʒuɡal	conjugal
konʒuɡare	conjugare
konopidə	conopidă
konsetʃintsə	consecință
konsekvent	consecvent
konsens	consens
konsidera	considera
konsiderabil	considerabil
konsideratsie	considerație
konspiratsie	conspirație
konstruit	construit
konsular	consular
kontabil	contabil
kontabile	contabile
kontabilj	contabili
kontabilə	contabilă
kontadʒios	contagios
kontinental	continental
kontinua	continua
kontinue	continue
kontinuj	continui
kontinuu	continuu
kontinuw	continuu
kontinuə	continuă
kontrabas	contrabas
kontrakt	contract
kontraktual	contractual
kontrar	contrar
kontraventsie	contravenție
kontrazitʃe	contrazice
kontrolatsj	controlați
kontur	contur
konventsie	convenție
konventsional	convențional
konversatsie	conversație
konversie	conversie
konviŋɡətor	convingător
konvinse	convinse
konʃtient	conștient
konʃtii̯ntsə	conștiință
kontsine	conține
kontsinut	conținut
kontsinuturj	conținuturi
kopak	copac
kopia	copia
kopja	copia
kopij	copii
kopiij	copiii
kopil	copil
kopilu	copilul
kopilul	copilul
kopiləri	copilări
kopitə	copită
kopiutsə	copiuță
kopleʃitoru	copleșitorul
kopleʃitorul	copleșitorul
kopt	copt
korb	corb
korbiw	corbiu
kordial	cordial
korekt	corect
koreɡraf	coregraf
koreɡrafə	coregrafă
koridə	coridă
koridʒibil	corigibil
koriʒabil	corijabil
korindon	corindon
kormoran	cormoran
kornut	cornut
koronavirus	coronavirus
korpus	corpus
korupe	corupe
korupt	corupt
kosito̯are	cositoare
kositor	cositor
kosmetitʃian	cosmetician
kosmetitʃianə	cosmeticiană
kosmik	cosmic
kosmonaut	cosmonaut
kosta	costa
kostarikan	costarican
kostier	costier
kostum	costum
kostume	costume
kotets	coteț
kotoj	cotoi
kotor	cotor
kotovajkə	cotovaică
kotovaje	cotovaie
kovriɡ	covrig
kovridʒej	covrigei
kovridʒel	covrigel
kovridʒj	covrigi
koʃmelie	coșmelie
kotsofanə	coțofană
kotsor	coțor
krak	crac
krakə	cracă
krampon	crampon
krap	crap
krater	crater
krea	crea
kreativ	creativ
kreator	creator
kreaturj	creaturi
kreaturə	creatură
kreatsie	creație
kred	cred
kredibil	credibil
kredintʃjos	credincios
kredintsə	credință
krejer	creier
krejon	creion
kreme	creme
kremə	cremă
kreskut	crescut
krevete	crevete
kreʃte̯a	creștea
kreʃtin	creștin
kreʃtine̯askə	creștinească
kreʃtinesk	creștinesc
kreʃtineʃte	creștinește
kreʃtineʃtj	creștinești
krets	creț
kriminoloɡ	criminolog
kriminolodʒik	criminologic
kriminolodʒist	criminologist
kriminolodʒistə	criminologistă
kriminoloɡə	criminologă
krin	crin
krinj	crini
krisalidə	crisalidă
krisopraz	crisopraz
kritik	critic
kritikabil	criticabil
krititʃism	criticism
krizə	criză
kroat	croat
kroatə	croată
krokodil	crocodil
krom	crom
kroŋk	cronc
kronkəw	croncău
kronik	cronic
krutʃadə	cruciadă
krutʃiʃ	cruciș
krud	crud
kruɡ	crug
krɨnɡ	crâng
krəpət	crăpăt
ku	cu
kwantum	cuantum
kubik	cubic
kuk	cuc
kutʃeritor	cuceritor
kukulə	cuculă
kukuve̯a	cucuvea
kudʒeta	cugeta
kulka	culca
kulkuʃ	culcuș
kulorj	culori
kult	cult
kultura	cultura
kum	cum
kumintʃjor	cumincior
kuminte	cuminte
kumplit	cumplit
kumpənə	cumpănă
kumpərəturj	cumpărături
kumpət	cumpăt
kumpəta	cumpăta
kunei̯form	cuneiform
kuno̯aʃte	cunoaște
kunoskut	cunoscut
kunoskətor	cunoscător
kunoʃtintsə	cunoștință
kununa	cununa
kununə	cunună
kuprins	cuprins
kuprinzətor	cuprinzător
kupru	cupru
kuptor	cuptor
kur	cur
kuraʒ	curaj
kuraʒos	curajos
kurat	curat
kurbat	curbat
kurbə	curbă
kurkan	curcan
kurkə	curcă
kure̯a	curea
kurent	curent
kurios	curios
kurist	curist
kursiv	cursiv
kuru	curul
kurul	curul
kururile	cururile
kurɨnd	curând
kurətsa	curăța
kurətsat	curățat
kuskru	cuscru
kuskrə	cuscră
kusturə	custură
kusut	cusut
kutare	cutare
kute	cute
kutie	cutie
kuviintʃjos	cuviincios
kuvios	cuvios
kuvɨnta	cuvânta
kuvɨntare	cuvântare
kuʃer	cușer
kvas	cvas
sajborɡ	cyborg
kɨjne	câine
kɨjnos	câinos
kɨmp	câmp
kɨmpe̯an	câmpean
kɨmpene̯askə	câmpenească
kɨmpenesk	câmpenesc
kɨmpeneʃtj	câmpenești
kɨmpie	câmpie
kɨnd	când
kɨndva	cândva
kɨne	câne
kɨnepə	cânepă
kɨntar	cântar
kɨntare	cântare
kɨntat	cântat
kɨnte	cânte
kɨntek	cântec
kɨntəre̯atsa	cântăreața
kɨntərets	cântăreț
kɨntəretsele	cântărețele
kɨntəretsij	cântăreții
kɨntəretsu	cântărețul
kɨntəretsul	cântărețul
kɨntəri	cântări
kɨntərj	cântări
kɨntətor	cântător
kɨrtʃel	cârcel
kɨrʒə	cârjă
kɨrn	cârn
kɨrpiturə	cârpitură
kɨrtitsə	cârtiță
kɨt	cât
kɨte	câte
kɨte̯odatə	câteodată
kɨtə	câtă
kɨʃtiɡa	câștiga
kɨtsj	câți
kə	că
kətʃj	căci
kətʃjulə	căciulă
kədintsə	cădință
kəi	căi
kəj	căi
kəlare	călare
kəldəraʃ	căldăraș
kəluɡər	călugăr
kəluɡəritsə	călugăriță
kələtor	călător
kəltsun	călțun
kəmaʃə	cămașă
kəmilə	cămilă
kəpetenie	căpetenie
kəpos	căpos
kəpre̯askə	căprească
kəpresk	căpresc
kəpreʃtj	căprești
kəpruj	căprui
kəput	căput
kəpuʃə	căpușă
kəpətui	căpătui
kəpətsɨnos	căpățânos
kəpʃor	căpșor
kəpʃunə	căpșună
kərare	cărare
kərbune	cărbune
kərindar	cărindar
kərnos	cărnos
kərunt	cărunt
kərəbuʃ	cărăbuș
kərəmiziw	cărămiziu
kəskəund	căscăund
kəsj	căsi
kəsnitʃije	căsnicie
kətre	către
kəuta	căuta
kəwta	căuta
kəuʃ	căuș
kəzut	căzut
kəʃuna	cășuna
kətsel	cățel
kətseluʃ	cățeluș
kətseluʃə	cățelușă
d	d
da	da'
datʃj	daci
daktilik	dactilic
daj	dai
dalie	dalie
damnat	damnat
dansat	dansat
dansator	dansator
dar	dar
darəmite	darămite
dat	dat
dator	dator
datoritə	datorită
daw	dau
de̯asupra	deasupra
de̯asə	deasă
debandadə	debandadă
dekafeinizat	decafeinizat
dekaɡram	decagram
dekapitatsie	decapitație
dekapitatsje	decapitație
detʃembrije	decembrie
detʃent	decent
detʃisiv	decisiv
deklaratsie	declarație
deklaratsiː	declarații
deklina	declina
deklinare	declinare
dekora	decora
dekɨt	decât
dedesubt	dedesubt
dedesupt	dedesubt
defel	defel
defilew	defileu
defileurj	defileuri
definitsie	definiție
dedʒenera	degenera
dedʒet	deget
dedʒete	degete
deɡrabə	degrabă
deɡresa	degresa
deɡresat	degresat
deʒun	dejun
delekta	delecta
delektare	delectare
delektərj	delectări
delibera	delibera
delikat	delicat
delikate	delicate
delitʃos	delicios
delitʃju	deliciu
demn	demn
demnitar	demnitar
demoɡraf	demograf
demoɡrafə	demografă
demonstrabil	demonstrabil
dens	dens
dentist	dentist
dentistə	dentistă
deo̯aretʃe	deoarece
deodatə	deodată
de̯odatə	deodată
deosebi	deosebi
deosebit	deosebit
departe	departe
dependent	dependent
deplinətate	deplinătate
deprimat	deprimat
depərta	depărta
depərtare	depărtare
deranʒa	deranja
derivativ	derivativ
derivatsie	derivație
dermatoloɡ	dermatolog
dermatoloɡə	dermatologă
derviʃ	derviș
des	des
deskriere	descriere
deskults	desculț
deskurkərets	descurcăreț
deskətuʃa	descătușa
desfide	desfide
desfəta	desfăta
desfətare	desfătare
desfətərj	desfătări
desfəʃura	desfășura
desfəʃurat	desfășurat
desiɡur	desigur
despotik	despotic
despərtsitor	despărțitor
destin	destin
destinatsie	destinație
desto̯artʃe	destoarce
desəvɨrʃi	desăvârși
detaliat	detaliat
detalju	detaliu
deteriorat	deteriorat
determina	determina
developa	developa
deveni	deveni
devenj	deveni
devreme	devreme
dezambala	dezambala
dezamədʒi	dezamăgi
dezamədʒit	dezamăgit
dezamədʒitor	dezamăgitor
dezɡustətor	dezgustător
dezitʃe	dezice
dezmjerda	dezmierda
dezvolta	dezvolta
dezvoltat	dezvoltat
deʃert	deșert
deʃteptul	deșteptul
deʃteptətʃjune	deșteptăciune
deʃuruba	deșuruba
diakon	diacon
diakritik	diacritic
dialekt	dialect
dialektal	dialectal
dialektolodʒie	dialectologie
diamant	diamant
diastolik	diastolic
diktsionar	dicționar
diferi	diferi
diferit	diferit
difitʃil	dificil
diftonɡa	diftonga
didʒital	digital
diɡn	dign
dihanie	dihanie
dihor	dihor
dimine̯atsa	dimineața
dimine̯atsə	dimineață
dimpreʒur	dimprejur
din	din
dinam	dinam
dinamik	dinamic
dinozaur	dinozaur
dintru	dintru
dintsiʃor	dințișor
dioksid	dioxid
direkt	direct
distʃiplina	disciplina
diskulpa	disculpa
diskutsie	discuție
distantsa	distanța
distantsə	distanță
distinkt	distinct
distrate	distrate
distratsj	distrați
distruktiv	distructiv
distɾudʒe	distruge
distɾudʒere	distrugere
distɾuɡətor	distrugător
divaɡa	divaga
divers	divers
diversifikare	diversificare
dividend	dividend
divin	divin
do	do
do̯amnə	doamnă
do̯ar	doar
dobɨndə	dobândă
doktor	doctor
doktorə	doctoră
dokument	document
doɡmatik	dogmatic
doj	doi
dojle̯a	doilea
dojne	doine
dojnə	doină
dojsprezetʃe	doisprezece
dojsprezetʃele̯a	doisprezecelea
dojʃpe	doișpe
dojʃpele̯a	doișpelea
domestik	domestic
domestitʃi	domestici
domina	domina
domn	domn
domne̯askə	domnească
domnesk	domnesc
domneʃtj	domnești
domnitor	domnitor
domnule	domnule
domol	domol
dor	dor
dorit	dorit
dos	dos
dosi	dosi
dowa	doua
dowə	două
dowəsprezetʃe	douăsprezece
dowəsprezetʃe̯a	douăsprezecea
dowəzetʃe̯a	douăzecea
dowəzetʃj	douăzeci
dowəzetʃile̯a	douăzecilea
dowəʃpe	douășpe
dowəʃpe̯a	douășpea
dratʃj	draci
draɡon	dragon
draɡoste	dragoste
draɡostej	dragostei
draɡə	dragă
dram	dram
dramatik	dramatic
dramaturɡ	dramaturg
drenaʒ	drenaj
drepne̯a	drepnea
dreptatʃj	dreptaci
dreptuŋɟular	dreptunghiular
driadə	driadă
droɡa	droga
droɡat	drogat
droɡurj	droguri
dromader	dromader
dronɡo	drongo
dropie	dropie
drum	drum
drəkos	drăcos
drəkuʃor	drăcușor
dubios	dubios
dublu	dublu
dukal	ducal
dukat	ducat
dutʃe	duce
duh	duh
dujos	duios
dultʃe	dulce
dultʃe̯aɡ	dulceag
dultʃe̯atsə	dulceață
dumesnik	dumesnic
duminika	duminica
duminikə	duminică
dumne̯ajej	dumneaei
dumne̯alor	dumnealor
dumne̯aluj	dumnealui
dumne̯ata	dumneata
dumnezeesk	dumnezeesc
dumnezejaskə	dumnezeiască
dumnezejesk	dumnezeiesc
dumnezejeʃtj	dumnezeiești
dumə	dumă
duŋɡat	dungat
duodetʃimal	duodecimal
dupə	după
dur	dur
dura	dura
dure̯a	durea
durere	durere
dureros	dureros
dururos	dururos
duʃ	duș
duʃman	dușman
dɨrə	dâră
dəlbior	dălbior
dəntsuitor	dănțuitor
dərɨma	dărâma
e	e
je	e
e̯a	ea
ja	ea
ebraik	ebraic
ebraikə	ebraică
ekidnə	echidnă
ekilibru	echilibru
ekinoktsju	echinocțiu
eklektik	eclectic
ekoloɡ	ecolog
ekoloɡə	ecologă
ekonom	econom
ekonomik	economic
ekonomist	economist
ekonomistə	economistă
ekran	ecran
ekranare	ecranare
ekuadorian	ecuadorian
ekuatorial	ecuatorial
editorjal	editorial
editsie	ediție
edukatsie	educație
efektiv	efectiv
efikatʃe	eficace
eɡal	egal
jej	ei
jel	el
jele	ele
elektorat	electorat
elektrik	electric
elektritʃian	electrician
elektritʃianə	electriciană
elektromaɡnetik	electromagnetic
elefant	elefant
elementar	elementar
elibera	elibera
elinikə	elinică
elizew	elizeul
elizewl	elizeul
elokvent	elocvent
elokventsə	elocvență
email	email
imejl	email
emerit	emerit
emiɡra	emigra
emotiv	emotiv
emotsional	emoțional
empirik	empiric
emula	emula
emulator	emulator
entʃiklopedija	enciclopedia
entʃiklopedije	enciclopedie
eŋɡlez	englez
eŋɡleze	engleze
eŋɡlezeʃtj	englezești
enorm	enorm
entomoloɡ	entomolog
entomoloɡə	entomologă
entratə	entrată
entuziasma	entuziasma
epifanije	epifanie
episkopal	episcopal
jeram	eram
erektil	erectil
erektsie	erecție
erede	erede
eronat	eronat
erpetoloɡ	erpetolog
erpetoloɡə	erpetologă
erzats	erzaț
esofadʒitə	esofagită
espadrilə	espadrilă
jeste	este
estetitʃian	estetician
estetitʃianə	esteticiană
estiv	estiv
estival	estival
eston	eston
estonian	estonian
estoniene	estoniene
ettʃetera	etcetera
eterodʒen	eterogen
etil	etil
etilik	etilic
etimwane	etimoane
etimolodʒik	etimologic
etimolodʒie	etimologie
etimon	etimon
etnoloɡ	etnolog
etnoloɡə	etnologă
etoloɡ	etolog
etrusk	etrusc
ew	eu
jew	eu
jo	eu
eu̯ro	euro
europe̯an	european
evapora	evapora
evaziv	evaziv
evlavie	evlavie
evlavios	evlavios
evlaviosu	evlaviosul
evlaviosul	evlaviosul
evrejaskə	evreiască
evrejkə	evreică
evrejesk	evreiesc
evrejeʃtj	evreiești
evre̯u	evreu
eɡzakt	exact
eksadʒerat	exagerat
eksadʒeratsie	exagerație
eɡzasperat	exasperat
ekstʃelent	excelent
ekstʃepta	excepta
ekstʃeptsional	excepțional
eksklude	exclude
ekskretsie	excreție
eɡzekutsie	execuție
eksemplar	exemplar
eɡzertʃita	exercita
ekshuma	exhuma
eɡzotik	exotic
eksotoksinə	exotoxină
ekspatria	expatria
eksperimentat	experimentat
ekspiratsie	expirație
eksplikativ	explicativ
eksplitʃitate	explicitate
eksploatare	exploatare
eksplozibil	explozibil
ekspresie	expresie
eksterior	exterior
eksterna	externa
ekstraordinar	extraordinar
eʃarfə	eșarfă
etsetera	ețetera
f	f
fak	fac
fatʃe	face
fatʃere	facere
fad	fad
faɡot	fagot
fajmos	faimos
fajn	fain
falik	falic
faliment	faliment
falimenta	falimenta
fals	fals
falus	falus
falə	fală
familial	familial
faptu	faptul
faptul	faptul
faptə	faptă
far	far
farmatʃist	farmacist
farmatʃistə	farmacistă
farmakoloɡ	farmacolog
farmakoloɡə	farmacologă
farmek	farmec
fault	fault
faulə	faulă
fazan	fazan
februarie	februarie
februarje	februarie
febrwarie	februarie
febrwarje	februarie
fetʃjo̯arə	fecioară
federal	federal
federativ	federativ
federatsie	federație
fel	fel
felatsiej	felației
felia	felia
felitʃita	felicita
felinə	felină
felul	felul
feluri	feluri
felurj	feluri
felurit	felurit
femej	femei
femeja	femeia
femejaskə	femeiască
femejesk	femeiesc
femejeʃtj	femeiești
femeij	femeii
femele	femele
femelə	femelă
feminine	feminine
fere̯astrə	fereastră
ferestrui	ferestrui
ferestruit	ferestruit
feritʃe	ferice
feritʃire	fericire
feritʃire̯a	fericirea
feritʃit	fericit
fermeka	fermeca
fermekətor	fermecător
fermenta	fermenta
fermentatsie	fermentație
fertil	fertil
fertiliza	fertiliza
fesə	fesă
feudalism	feudalism
fetsj	feți
fetsiʃo̯arə	fețișoară
fjarej	fiarei
fibros	fibros
fidejusiune	fideiusiune
fidejusjune	fideiusiune
fidel	fidel
fiekare	fiecare
fjer	fier
fjerbintʃjor	fierbincior
fjert	fiert
fierəstruit	fierăstruit
fiind	fiind
fiindkə	fiindcă
fiintsa	ființa
fiintse	ființe
fiintsə	ființă
fiʒian	fijian
filamentos	filamentos
filantropik	filantropic
filiɡran	filigran
film	film
filmul	filmul
filozofie	filozofie
fin	fin
finisa	finisa
fir	fir
firav	firav
fire	fire
fire̯askə	firească
fire̯o	fireo
firesk	firesc
firetik	firetic
fireʃte	firește
fireʃtj	firești
fitil	fitil
fitoloɡ	fitolog
fitoloɡə	fitologă
fizik	fizic
fizitʃian	fizician
fizitʃianə	fiziciană
fizioloɡ	fiziolog
fizioloɡə	fiziologă
fitsujkə	fițuică
flamand	flamand
flaminɡo	flamingo
fle̯ak	fleac
flekar	flecar
fleɡmə	flegmă
fleksibil	flexibil
flo̯are	floare
flo̯are̯a	floarea
flokos	flocos
flor	flor
florar	florar
florentin	florentin
florentina	florentina
florentine	florentine
florentinj	florentini
florentinə	florentină
floritʃikə	floricică
florist	florist
floristə	floristă
flotant	flotant
flujera	fluiera
flor	fluor
fluor	fluor
fluvju	fluviu
fləkəw	flăcău
fləmɨnd	flămând
fləmɨnzi	flămânzi
fo̯ame̞	foame
fo̯amete	foamete
fok	foc
fokos	focos
fokə	focă
foitʃikə	foicică
fojos	foios
foljo	folio
folosi	folosi
folosintsə	folosință
fond	fond
fondator	fondator
fondurj	fonduri
fonem	fonem
fonetik	fonetic
forestier	forestier
formal	formal
format	format
formata	formata
formatu	formatul
formatul	formatul
formatə	formată
formatsie	formație
formidabil	formidabil
formulə	formulă
fosfor	fosfor
fosilə	fosilă
fotbal	fotbal
fotbalist	fotbalist
fotbalistə	fotbalistă
fotobiolodʒie	fotobiologie
fotoɡrafij	fotografii
fotolju	fotoliu
fradʒed	fraged
fradʒil	fragil
fraɡment	fragment
fraɡə	fragă
frajer	fraier
fraŋk	franc
frantʃeze	franceze
frantʃezə	franceză
frantsuz	franțuz
frantsuze̯askə	franțuzească
frantsuzesk	franțuzesc
frantsuzeʃtj	franțuzești
frasin	frasin
frekvent	frecvent
frekventativ	frecventativ
frekventsə	frecvență
frikos	fricos
frikə	frică
friɡuro̯asə	friguroasă
friɡuros	friguros
fript	fript
frizeritsə	frizeriță
fruɡal	frugal
frumos	frumos
frumusetse̯a	frumusețea
frunziʃ	frunziș
frunzos	frunzos
frunzə	frunză
frɨmbiat	frâmbiat
frɨna	frâna
frɨndʒe	frânge
frɨnt	frânt
frɨnturə	frântură
frɨnə	frână
frɨw	frâu
frədʒezi	frăgezi
fudul	fudul
fuɡatʃj	fugaci
fudʒi	fugi
fudʒit	fugit
fuɡəri	fugări
fuɡəw	fugău
fuj	fui
fulɡ	fulg
fuldʒerətor	fulgerător
fulɡui	fulgui
fumar	fumar
fumuriw	fumuriu
fumətor	fumător
fundal	fundal
fundamental	fundamental
fundaʃ	fundaș
fundatsie	fundație
fundə	fundă
fura	fura
furios	furios
furnikar	furnicar
furtunos	furtunos
fustə	fustă
futabil	futabil
futandʒiw	futangiu
fututu	fututul
fututul	fututul
futɨnd	futând
fɨntɨnə	fântână
fɨrʃerot	fârșerot
fɨsə	fâsă
fɨʃiwarə	fâșioară
fɨtsə	fâță
fəkətor	făcător
fəɡədui	făgădui
fəɡədujalə	făgăduială
fəɡədujelj	făgăduieli
fəinos	făinos
fəlkos	fălcos
fəptaʃ	făptaș
fəptaʃə	făptașă
fəpturj	făpturi
fəpturə	făptură
fərʃerot	fărșerot
fərʃerotesk	fărșerotesc
fərʃərot	fărșărot
fərʃərotesk	fărșărotesc
fəwrar	făurar
fəuri	făuri
fətsiʃ	fățiș
dʒ	g
ɡ	g
ɡabor	gabor
ɡajtsə	gaiță
ɡalben	galben
ɡalbenj	galbeni
ɡalenə	galenă
ɡalfed	galfed
ɡalju	galiu
ɡalvanizat	galvanizat
ɡamba	gamba
ɡambə	gambă
ɡaraʒ	garaj
ɡarnizo̯anə	garnizoană
ɡarson	garson
ɡastrik	gastric
ɡata	gata
ɡavial	gavial
ɡazelə	gazelă
dʒe̯akə	geacă
dʒe̯am	geam
dʒe̯amən	geamăn
dʒelos	gelos
dʒen	gen
dʒenealodʒist	genealogist
dʒenealodʒistə	genealogistă
dʒenerik	generic
dʒenetitʃian	genetician
dʒenetitʃianə	geneticiană
dʒenju	geniu
dʒeotʃentrik	geocentric
dʒeofizitʃian	geofizician
dʒeofizitʃianə	geofiziciană
dʒeoɡraf	geograf
dʒeoɡrafik	geografic
dʒeoɡrafie	geografie
dʒe̯oɡrafie	geografie
dʒeoɡrafə	geografă
dʒeoid	geoid
dʒeoloɡ	geolog
dʒeolodʒie	geologie
dʒeoloɡə	geologă
dʒe̯ordʒian	georgian
dʒerar	gerar
dʒeriatru	geriatru
dʒeriatrə	geriatră
dʒerman	german
dʒermanju	germaniu
dʒermanə	germană
dʒermənar	germănar
dʒestiona	gestiona
dʒestionar	gestionar
dʒestionarj	gestionari
dʒestiune	gestiune
dʒestiunj	gestiuni
dʒet	get
ɡe̯atsə	gheață
ɡepard	ghepard
ɡerɡinə	gherghină
ɡitʃi	ghici
ɡitʃit	ghicit
ɡitʃito̯are	ghicitoare
ɡid	ghid
ɡidə	ghidă
ɡimpe	ghimpe
ɡinduros	ghinduros
ɡiono̯aje	ghionoaie
ɡjont	ghiont
dʒimnast	gimnast
dʒimnastə	gimnastă
dʒinekoloɡ	ginecolog
dʒinekoloɡə	ginecologă
dʒinere	ginere
dʒiŋɡaʃ	gingaș
dʒirafa	girafa
dʒirafə	girafă
dʒiruetə	giruetă
ɡlatʃioloɡ	glaciolog
ɡlatʃioloɡə	glaciologă
ɡladiolə	gladiolă
ɡlandulos	glandulos
ɡlas	glas
ɡlonts	glonț
ɡlorifikator	glorificator
ɡlukoze	glucoze
ɡlukozə	glucoză
ɡlumə	glumă
ɡləstʃjor	glăscior
ɡnomon	gnomon
ɡnostik	gnostic
ɡoɡo̯aʃə	gogoașă
ɡoɡonat	gogonat
ɡoɡoʃj	gogoși
ɡoɡə	gogă
ɡol	gol
ɡoni	goni
ɡorɡonə	gorgonă
ɡorilə	gorilă
ɡospodar	gospodar
ɡospodinə	gospodină
ɡospodəre̯askə	gospodărească
ɡospodəresk	gospodăresc
ɡospodəreʃtj	gospodărești
ɡrafem	grafem
ɡrafit	grafit
ɡrafoman	grafoman
ɡram	gram
ɡramatikə	gramatică
ɡranat	granat
ɡranɡur	grangur
ɡras	gras
ɡraur	graur
ɡrav	grav
ɡravat	gravat
ɡravid	gravid
ɡravidə	gravidă
ɡravitatsional	gravitațional
ɡratsie	grație
ɡratsje	grație
ɡre̯akə	greacă
ɡrebla	grebla
ɡrek	grec
ɡretʃe̯askə	grecească
ɡretʃesk	grecesc
ɡretʃeʃtj	grecești
ɡrekotej	grecotei
ɡreɡar	gregar
ɡrejer	greier
ɡreoj	greoi
ɡresa	gresa
ɡrew	greu
ɡreuintsə	greuință
ɡreʃe̯alə	greșeală
ɡreʃi	greși
ɡretsos	grețos
ɡri	gri
ɡriʒanie	grijanie
ɡriʒuliw	grijuliu
ɡriʒə	grijă
ɡrindinə	grindină
ɡro̯aznik	groaznic
ɡrox	groh
ɡros	gros
ɡrotə	grotă
ɡruje	gruie
ɡruməʒor	grumăjor
ɡrɨw	grâu
ɡrəbi	grăbi
ɡrədinar	grădinar
ɡrədinj	grădini
ɡrədinitsə	grădiniță
ɡrədinəre̯asə	grădinăreasă
ɡrədinəri	grădinări
ɡrəitor	grăitor
ɡrəmadə	grămadă
ɡrəməʒo̯arə	grămăjoară
ɡrəsun	grăsun
ɡrəsuts	grăsuț
ɡuɡuʃtjuk	guguștiuc
ɡunojer	gunoier
ɡunojerə	gunoieră
ɡuraliv	guraliv
ɡureʃ	gureș
ɡurə	gură
ɡust	gust
ɡustar	gustar
ɡustos	gustos
ɡustul	gustul
ɡuvern	guvern
ɡuvernamental	guvernamental
ɡuvernant	guvernant
ɡuvernante	guvernante
ɡuvernantə	guvernantă
ɡuvernantsj	guvernanți
ɡɨmba	gâmba
ɡɨnd	gând
ɡɨndak	gândac
ɡɨndi	gândi
ɡɨrbov	gârbov
ɡɨskan	gâscan
ɡɨskə	gâscă
ɡəinə	găină
ɡəlbeʒor	gălbejor
ɡəlbenuʃ	gălbenuș
ɡəlbiw	gălbiu
ɡəlbuj	gălbui
ɡələdʒie	gălăgie
ɡələdʒios	gălăgios
ɡəo̯atʃe	găoace
ɡəotʃj	găoci
ɡəozar	găozar
ɡəsi	găsi
ɡəte̯alə	găteală
ɡəteʒ	gătej
ɡəti	găti
ɡəunos	găunos
h	h
hajde	haide
hajduk	haiduc
haitian	haitian
halat	halat
ham	ham
hamadriadə	hamadriadă
hamster	hamster
handbal	handbal
harfə	harfă
harnik	harnic
haw	hau
havuz	havuz
hazardat	hazardat
hazliw	hazliu
hats	haț
hektoɡram	hectogram
hedʒemon	hegemon
hej	hei
heliotʃentrik	heliocentric
heliodor	heliodor
helju	heliu
hematit	hematit
hematolodʒie	hematologie
heptametru	heptametru
heriŋɡ	hering
hertseɡ	herțeg
heteroɡam	heterogam
heteroseksual	heterosexual
heksadetʃimal	hexadecimal
heksaɡonal	hexagonal
heksametru	hexametru
hidratsj	hidrați
hidrodʒen	hidrogen
hidroloɡ	hidrolog
hidroloɡə	hidrologă
hiperbolə	hiperbolă
hipopotam	hipopotam
hispanik	hispanic
histolodʒik	histologic
hodʒet	hoget
homeopat	homeopat
homofobik	homofobic
homoseksual	homosexual
hortikulto̯are	horticultoare
hortikultor	horticultor
hostie	hostie
hotar	hotar
hotel	hotel
hotə	hotă
hram	hram
hranə	hrană
hre̯an	hrean
hriʃkə	hrișcă
hulit	hulit
hurduka	hurduca
hɨrbui	hârbui
hɨrtʃjoɡ	hârciog
hɨrtije	hârtie
hɨrtəw	hârtău
i	i
j	i
j	i
ja	ia
jak	iac
jakə	iacă
jad	iad
jadə	iadă
jamb	iamb
januarie	ianuarie
janwarie	ianuarie
janwarje	ianuarie
japə	iapă
jar	iar
jarbə	iarbă
jarnə	iarnă
jatə	iată
iberik	iberic
ikre	icre
ikrə	icră
identik	identic
identifika	identifica
identifikabil	identificabil
identitətsj	identități
idiom	idiom
idiot	idiot
ije	ie
jed	ied
jede	iede
jedere	iedere
jederə	iederă
jeftin	ieftin
jeftini	ieftini
jeftior	ieftior
jenibahar	ienibahar
jenuperj	ienuperi
jenupər	ienupăr
jepe	iepe
jepurar	iepurar
jepure	iepure
jepurj	iepuri
jerbar	ierbar
jerbos	ierbos
jerj	ieri
jernatik	iernatic
jernj	ierni
jertat	iertat
jerte	ierte
jeruŋkə	ieruncă
jezmətʃune	iezmăciune
jeʃi	ieși
iɡnora	ignora
ihtioloɡ	ihtiolog
ihtioloɡə	ihtiologă
ii	ii
ij	ii
ileɡal	ilegal
iluminatsie	iluminație
iluzorju	iluzoriu
iluzorju	iluzoriul
iluzorjul	iluzoriul
imadʒinatsie	imaginație
imam	imam
imbus	imbus
imediat	imediat
imitare	imitare
imnik	imnic
imoral	imoral
imortal	imortal
imos	imos
impas	impas
imperfekt	imperfect
imperial	imperial
implika	implica
implikatsie	implicație
imposibil	imposibil
impotentsə	impotență
imprekatsie	imprecație
imprediktibil	impredictibil
impronuntsabil	impronunțabil
imputatsie	imputație
imunoloɡ	imunolog
imunoloɡə	imunologă
inamitʃitsie	inamiciție
inbus	inbus
inklude	include
iŋkomplet	incomplet
iŋkompleta	incompleta
inkredibil	incredibil
inkubator	incubator
indetʃent	indecent
indiferent	indiferent
indispensabil	indispensabil
indisponibil	indisponibil
indolent	indolent
indonezian	indonezian
indonezianə	indoneziană
indutʃe	induce
industrjal	industrial
industrializat	industrializat
inel	inel
inelar	inelar
inertsie	inerție
inestetik	inestetic
inestimabil	inestimabil
ineksplikabil	inexplicabil
ineksprimabil	inexprimabil
inferior	inferior
infern	infern
infirm	infirm
infirma	infirma
infirmare	infirmare
infirmj	infirmi
infirmier	infirmier
infirmierə	infirmieră
infirmərj	infirmări
inflamabil	inflamabil
inflatsie	inflație
infleksibil	inflexibil
influentsa	influența
influentsabil	influențabil
influentsə	influență
informa	informa
informatikə	informatică
informatsie	informație
inimitʃitsie	inimiciție
inimos	inimos
inotʃent	inocent
inovatsie	inovație
ins	ins
inskriptsie	inscripție
inseparabil	inseparabil
insertsie	inserție
insidios	insidios
insolit	insolit
inspekto̯are	inspectoare
inspektor	inspector
inspiratsie	inspirație
instabil	instabil
instantanew	instantaneu
instinkt	instinct
institutsie	instituție
institutsiː	instituții
institutsional	instituțional
instrukto̯are	instructoare
instruktor	instructor
instrumental	instrumental
insular	insular
insurmontabil	insurmontabil
intakt	intact
inteɡra	integra
inteɡrabil	integrabil
inteɡral	integral
inteɡru	integru
intelektual	intelectual
intelidʒent	inteligent
intelidʒibil	inteligibil
intempestiv	intempestiv
intempestive	intempestive
intens	intens
intensifika	intensifica
intentsie	intenție
interferentsə	interferență
intermediar	intermediar
internatsional	internațional
interzitʃe	interzice
interzis	interzis
intim	intim
intimida	intimida
intoksikatsie	intoxicație
intra	intra
intranzitiv	intranzitiv
introduktiv	introductiv
inuman	inuman
inundatsie	inundație
inutil	inutil
invalid	invalid
invalida	invalida
invalidare	invalidare
invalidərj	invalidări
invalizj	invalizi
invar	invar
invariabil	invariabil
inventsie	invenție
invers	invers
investitsie	investiție
invidios	invidios
invintʃibil	invincibil
invita	invita
invitatsie	invitație
invizibil	invizibil
invulnerabil	invulnerabil
inʃj	inși
jobaɡ	iobag
jobədʒie	iobăgie
ionizatsie	ionizație
ipokrit	ipocrit
ipokritə	ipocrită
irastʃibil	irascibil
ireversibil	ireversibil
iritabil	iritabil
iritat	iritat
irlandez	irlandez
irlandezə	irlandeză
ironija	ironia
ironizator	ironizator
irosi	irosi
islam	islam
isostʃel	isoscel
isprəvnitʃel	isprăvnicel
istets	isteț
istorik	istoric
italian	italian
iteratsie	iterație
jubi	iubi
jubire	iubire
jubire̯a	iubirea
julije	iulie
junije	iunie
jute	iute
ivoriw	ivoriu
izbɨndə	izbândă
izoɡam	izogam
izolat	izolat
izvor	izvor
ʒ	j
ʒaketə	jachetă
ʒaɡuar	jaguar
ʒale	jale
ʒale̯a	jalea
ʒalej	jalei
ʒalnik	jalnic
ʒamajkan	jamaican
ʒandarm	jandarm
ʒaponezə	japoneză
ʒasp	jasp
ʒavrə	javră
ʒder	jder
ʒeɡ	jeg
ʒeɡos	jegos
ʒerpeli	jerpeli
ʒerpeliturə	jerpelitură
ʒidan	jidan
ʒiɡni	jigni
ʒir	jir
ʒne̯apən	jneapăn
ʒnepenj	jnepeni
ʒo̯akə	joacă
ʒok	joc
ʒoj	joi
dʒojnt	joint
dʒokər	joker
ʒos	jos
ʒul	joule
ʒovialitate	jovialitate
ʒuka	juca
ʒukat	jucat
ʒukətor	jucător
ʒude	jude
ʒudeka	judeca
ʒudekat	judecat
ʒudekatə	judecată
ʒudets	județ
ʒudetse	județe
ʒuɡar	jugar
ʒuɡular	jugular
ʒuɡənaʃ	jugănaș
ʒuʒubə	jujubă
ʒumate	jumate
ʒune	june
ʒur	jur
ʒura	jura
ʒurare	jurare
ʒurat	jurat
ʒurisdiktsie	jurisdicție
ʒurist	jurist
ʒuristə	juristă
ʒurəminte	jurăminte
ʒurəmɨnt	jurământ
ʒust	just
ʒustitsie	justiție
ʒuvenil	juvenil
ʒuvenilə	juvenilă
ʒuzj	juzi
ʒəratik	jăratic
kaki	kaki
kalju	kaliu
karate	karate
kiloɡram	kilogram
kirɡiz	kirghiz
kiribatian	kiribatian
koala	koala
kosovar	kosovar
kripton	kripton
kurd	kurd
kɨrɡɨz	kârgâz
l	l
la	la
labadʒiw	labagiu
lakom	lacom
laɡər	lagăr
laj	lai
laje	laie
lale̯a	lalea
lamə	lamă
lants	lanț
leptop	laptop
lasə	lasă
lat	lat
latin	latin
latrone	latrone
laudə	laudă
lavandə	lavandă
laʃ	laș
le	le
le̯apʃa	leapșa
le̯apʃə	leapșă
lebede	lebede
ledʒe	lege
ledʒendar	legendar
ledʒisla	legisla
leɡəturə	legătură
lej	lei
leʒer	lejer
lemiŋɡ	leming
lemnos	lemnos
lenevjor	lenevior
leneʃ	leneș
leo̯ajkə	leoaică
le̯o̯arkə	leoarcă
leopard	leopard
le̯orbəw	leorbău
lepidopteroloɡ	lepidopterolog
lepidopteroloɡə	lepidopterologă
lesbian	lesbian
lesbianə	lesbiană
leton	leton
letonə	letonă
lew	leu
leksikoɡraf	lexicograf
leksikoɡrafə	lexicografă
libelulə	libelulă
liber	liber
liberatsie	liberație
libertate	libertate
licid	lichid
likiditate	lichiditate
likuritʃj	licurici
lift	lift
liftə	liftă
liliakiw	liliachiu
limbi	limbi
limbut	limbut
limbə	limbă
limite	limite
limnoloɡ	limnolog
limnoloɡə	limnologă
limpede	limpede
limpeʒor	limpejor
lin	lin
lindinə	lindină
linɡow	lingou
linɡourj	lingouri
linɡvist	lingvist
liŋɡvistik	lingvistic
linɡvistikə	lingvistică
linɡvistə	lingvistă
liniar	liniar
liniat	liniat
liniʃor	linișor
liniʃte	liniște
links	linx
linə	lină
lipitʃjos	lipicios
lipit	lipit
litera	litera
literar	literar
literarizat	literarizat
literaturə	literatură
litju	litiu
litoɡraf	litograf
litoɡrafə	litografă
lituanian	lituanian
lituanianə	lituaniană
livadə	livadă
lizibil	lizibil
lobiist	lobbyist
lobiistə	lobbyistă
lok	loc
lokal	local
lokatsie	locație
lokuintsə	locuință
lokutsiune	locuțiune
lopətar	lopătar
lor	lor
lori	lori
lot	lot
lotus	lotus
lua	lua
lwa	lua
luare	luare
lwat	luat
luatsj	luați
lubenitsə	lubeniță
lutʃed	luced
lutʃid	lucid
lutʃjos	lucios
lukra	lucra
lukrare	lucrare
lukrat	lucrat
lukratsj	lucrați
lukru	lucrul
lukrul	lucrul
lukrurj	lucruri
lukruʃor	lucrușor
lukrətor	lucrător
luɡubru	lugubru
luj	lui
lume	lume
lume̯a	lumea
luminos	luminos
luminə	lumină
lumɨnare	lumânare
luna	luna
lunar	lunar
lunatik	lunatic
lunekos	lunecos
luŋɡ	lung
lundʒi	lungi
lunj	luni
lunə	lună
lupe̯askə	lupească
lupesk	lupesc
lupeʃtj	lupești
lutier	lutier
lutos	lutos
lutrə	lutră
lɨntʃed	lânced
lɨnɡə	lângă
lɨnos	lânos
ləbərtsat	lăbărțat
ləkrimos	lăcrimos
ləkrəmos	lăcrămos
ləkətuʃ	lăcătuș
ləmɨje	lămâie
ləmɨitsə	lămâiță
ləptos	lăptos
ləptukə	lăptucă
ləpturj	lăpturi
ləsa	lăsa
ləsat	lăsat
lətiʃor	lătișor
ləuda	lăuda
ləudəros	lăudăros
ləudəroʃenie	lăudăroșenie
ləudətor	lăudător
ləutar	lăutar
m	m
mak	mac
matʃedoromɨn	macedoromân
makrow	macrou
makru	macru
maestru	maestru
maɡjar	maghiar
maɡjarj	maghiari
maɡjarə	maghiară
madʒik	magic
madʒitʃian	magician
madʒitʃianə	magiciană
madʒistru	magistru
maɡnet	magnet
maɡnezju	magneziu
mahala	mahala
maj	mai
majkə	maică
majmutsə	maimuță
maleabil	maleabil
malefik	malefic
mol	mall
maltez	maltez
maltezə	malteză
mamifer	mamifer
mamut	mamut
mamə	mamă
mandolinə	mandolină
mandolə	mandolă
mane̯a	manea
manekinu	manechinul
manekinul	manechinul
manɡan	mangan
manɡustə	mangustă
manifestant	manifestant
manual	manual
maoism	maoism
mape	mape
mapə	mapă
maratonist	maratonist
maratonistə	maratonistă
marka	marca
markaʒ	marcaj
mare̯a	marea
marfə	marfă
maria	maria
marja	maria
marin	marin
martije	martie
martir	martir
martor	martor
marts	marț
martsj	marți
masakru	masacru
maskulj	masculi
maskulin	masculin
maskə	mască
masturbarɛ	masturbare
masturbatu	masturbatul
masturbatul	masturbatul
masturbatsie	masturbație
masə	masă
matematik	matematic
matematitʃian	matematician
matematitʃianə	matematiciană
materialist	materialist
materie	materie
materje	materie
mator	mator
matrakukə	matracucă
matur	matur
maur	maur
maksim	maxim
mazəre	mazăre
maʃina	mașina
maʃinj	mașini
maʃinə	mașină
maʃterə	mașteră
me̯aser	measer
mekanik	mecanic
metʃj	meci
medik	medic
medikament	medicament
medikamente	medicamente
meditʃj	medici
medikə	medică
medie	medie
mediokru	mediocru
medju	mediu
meduzə	meduză
mej	mei
melk	melc
meltʃj	melci
mele	mele
melodie	melodie
membrane	membrane
membranos	membranos
membranə	membrană
memə	memă
mentenantsə	mentenanță
mentsine	menține
mentsinere	menținere
mentsinerj	mențineri
merkur	mercur
meresɨn	meresân
merdʒe	merge
merita	merita
meriʃo̯are	merișoare
meriʃor	merișor
meriʃorj	merișori
mermeli	mermeli
mese̯an	mesean
meser	meser
mestekarə	mestecară
metaforə	metaforă
metal	metal
metaliza	metaliza
metan	metan
meteoroloɡ	meteorolog
meteorolodʒikə	meteorologică
meteoroloɡə	meteorologă
metroloɡ	metrolog
metroloɡə	metrologă
mew	meu
meʃte	mește
mi	mi
mija	mia
mja	mia
miasmatik	miasmatic
mjasmə	miasmă
mjaw	miau
mjazəno̯apte	miazănoapte
mjazəzi	miazăzi
mik	mic
mikidutsə	michiduță
mikoloɡ	micolog
mikoloɡə	micologă
mikrobioloɡ	microbiolog
mikrobiolodʒik	microbiologic
mikrobioloɡə	microbiologă
mikuts	micuț
mie	mie
mjerkurj	miercuri
mjere	miere
mjerli	mierli
mjeros	mieros
miɡrenə	migrenă
mij	mii
miime	miime
milan	milan
miliɡram	miligram
milimetrik	milimetric
mintʃinos	mincinos
mintʃunə	minciună
mine	mine
miner	miner
mineral	mineral
mineraloɡ	mineralog
mineralodʒia	mineralogia
mineralodʒie	mineralogie
mineraloɡə	mineralogă
minifotbal	minifotbal
mint	mint
mintal	mintal
minte	minte
mintos	mintos
minuskul	minuscul
minutsios	minuțios
mintsi	minți
mintsj	minți
mintsitor	mințitor
mio̯arə	mioară
mjo̯arə	mioară
mjorlaw	miorlau
mjorləi	miorlăi
mire̯asə	mireasă
miresej	miresei
miresij	miresii
mirosi	mirosi
mirositor	mirositor
mistrets	mistreț
mititel	mititel
mitolodʒik	mitologic
mizer	mizer
mizerabil	mizerabil
mizerie	mizerie
miʃka	mișca
miʃkətor	mișcător
miʃel	mișel
mitsə	miță
mlədior	mlădior
mlədios	mlădios
mləditsə	mlădiță
mo̯ale	moale
mo̯arte	moarte
mo̯arte̯a	moartea
mo̯aʃə	moașă
model	model
moderatsie	moderație
modest	modest
modifikate	modificate
moʒdre̯an	mojdrean
molitʃel	molicel
molipsi	molipsi
moliʃor	molișor
moluskə	moluscă
moluʃte	moluște
mome̯alə	momeală
momentu	momentul
momentul	momentul
moneɡask	monegasc
moneɡaʃtj	monegaști
moŋɡol	mongol
monoaksial	monoaxial
monoɡam	monogam
monolit	monolit
monometru	monometru
monoplan	monoplan
monotrem	monotrem
monotremə	monotremă
monstru	monstru
montan	montan
monument	monument
monumental	monumental
moralitate	moralitate
morkovj	morcovi
morfem	morfem
moroj	moroi
morsə	morsă
mortar	mortar
mortier	mortier
mortsj	morți
motan	motan
mototʃiklist	motociclist
mototʃikliste	motocicliste
mototʃiklistə	motociclistă
mototʃikliʃtj	motocicliști
motor	motor
motorist	motorist
motoristə	motoristă
mov	mov
moʃne̯aɡ	moșneag
moʃnedʒj	moșnegi
mre̯anə	mreană
mɨsɨ	ms
mutʃed	muced
mutʃiladʒinos	mucilaginos
mutʃiladʒiu̯	mucilagiu
mukos	mucos
muezin	muezin
muflon	muflon
muje	muie
mujere	muiere
muist	muist
mult	mult
multe	multe
multiplikatsie	multiplicație
multipolar	multipolar
multsam	mulțam
multsj	mulți
muntʃi	munci
muntʃitorime	muncitorime
muŋkə	muncă
munte	munte
munte̯an	muntean
muntene̯askə	muntenească
muntenesk	muntenesc
munteneʃtj	muntenești
muntos	muntos
mur	mur
murdar	murdar
murɡ	murg
muribund	muribund
muritor	muritor
murə	mură
musketar	muschetar
muskulos	musculos
mustatsə	mustață
mustətʃjos	mustăcios
mut	mut
mutatsie	mutație
muzew	muzeu
muzikal	muzical
muzikə	muzică
muʃkjos	mușchios
muʃtar	muștar
mutsenie	muțenie
mɨjne̞	mâine
mɨjnj	mâini
mɨltʃi	mâlci
mɨnka	mânca
mɨnkare	mâncare
mɨnkətʃjos	mâncăcios
mɨndrie	mândrie
mɨndru	mândru
mɨŋɡɨja	mângâia
mɨntui	mântui
mɨnutsə	mânuță
mɨnz	mânz
mɨnzare	mânzare
mɨnzə	mânză
mɨnə	mână
mɨrtʃed	mârced
mɨrʃav	mârșav
mɨtsə	mâță
mə	mă
mətʃeləri	măcelări
mətʃjukə	măciucă
məkəle̯andru	măcăleandru
məɡar	măgar
məɡəre̯askə	măgărească
məɡəresk	măgăresc
məɡəreʃtj	măgărești
məj	măi
məjkutsə	măicuță
məjestru	măiestru
məjor	măior
məmikə	mămică
mənuʃə	mănușă
mər	măr
mərar	mărar
mərets	măreț
məri	mări
mərj	mări
mərime	mărime
mərinimos	mărinimos
mərire	mărire
mərit	mărit
məriʃor	mărișor
mərunt	mărunt
məruntsel	mărunțel
məruntsi	mărunți
məruntsj	mărunți
məruntsiʃ	mărunțiș
mərtsiʃor	mărțișor
məskəri	măscări
məse̯a	măsea
məslin	măslin
məsliniw	măsliniu
məslinə	măslină
məsəlar	măsălar
mətanie	mătanie
mətre̯atsə	mătreață
mətuʃə	mătușă
mətəhəlos	mătăhălos
n	n
nadir	nadir
najba	naiba
naiv	naiv
nativ	nativ
natrju	natriu
natural	natural
nauruan	nauruan
nautik	nautic
naviɡa	naviga
naviɡatsie	navigație
naʃpa	nașpa
naʃte	naște
naʃtere	naștere
natsie	nație
natsional	național
ne	ne
neadaptat	neadaptat
neadekvat	neadecvat
neaʒutorat	neajutorat
ne̯am	neam
neantitʃipat	neanticipat
neapərat	neapărat
neartikulat	nearticulat
neatɨrnare	neatârnare
neaʃteptat	neașteptat
nebotezat	nebotezat
netʃesar	necesar
netʃesita	necesita
nekibzuintsə	nechibzuință
nekibzuit	nechibzuit
netʃinstit	necinstit
nekomplikat	necomplicat
nekomunikat	necomunicat
nekomutabil	necomutabil
nekondʒelat	necongelat
nekontestat	necontestat
nekopt	necopt
nekrofor	necrofor
nekuviintʃjos	necuviincios
nekuviːntʃjos	necuviincios
nedrept	nedrept
neerlandez	neerlandez
neferitʃire	nefericire
neferitʃit	nefericit
nefertilizat	nefertilizat
neɡjob	neghiob
neɡliʒent	neglijent
neɡritʃjos	negricios
neɡriw	negriu
neɡrotej	negrotei
neɡru	negru
neɡuros	neguros
neɡurə	negură
neɡustore̯askə	negustorească
neɡustoresk	negustoresc
neɡustoreʃtj	negustorești
nehalit	nehalit
nejos	neios
neʒudekat	nejudecat
neliniar	neliniar
nelukrat	nelucrat
nemaskat	nemascat
nemeritat	nemeritat
nemernik	nemernic
nemilos	nemilos
nemuritor	nemuritor
nemtse̯askə	nemțească
nemtsesk	nemțesc
nemtseʃte	nemțește
nemtseʃtj	nemțești
nenorotʃit	nenorocit
nenufar	nenufar
nenumərabil	nenumărabil
nenumərat	nenumărat
neobiʃnuit	neobișnuit
neokolonijalist	neocolonialist
neoɡam	neogam
neomenesk	neomenesc
neon	neon
nepləkut	neplăcut
nepo̯atə	nepoată
nepopular	nepopular
nepot	nepot
nepotsj	nepoți
neprevizibil	neprevizibil
nepretsuit	neprețuit
neprietenos	neprietenos
nepəsətor	nepăsător
neras	neras
nerekunoskut	nerecunoscut
nereɡal	neregal
nereɡulat	neregulat
nerezervat	nerezervat
neruʃinat	nerușinat
nesokotit	nesocotit
nesomn	nesomn
nespəlat	nespălat
nestimat	nestimat
nesətul	nesătul
net	net
neted	neted
netezi	netezi
neujtabil	neuitabil
neurokirurɡ	neurochirurg
neuroloɡ	neurolog
neuroloɡə	neurologă
neutralizat	neutralizat
neutru	neutru
nevastə	nevastă
nevoje	nevoie
nevəstujkə	nevăstuică
nevəzətor	nevăzător
neɨmpjedikat	neîmpiedicat
neɨnkredere	neîncredere
neɨndemɨnare	neîndemânare
neɨndurat	neîndurat
neɨntemejat	neîntemeiat
neʃtiintsə	neștiință
neʃtiutor	neștiutor
nikaraɡuan	nicaraguan
nikel	nichel
nitʃjkɨnd	nicicând
nitʃjo	nicio
nitʃjun	niciun
nidʒerian	nigerian
nimfə	nimfă
nimik	nimic
nimitʃitor	nimicitor
nindʒe	ninge
niŋɡəw	ningău
nins	nins
niskaj	niscai
nisip	nisip
nisipos	nisipos
nitrodʒen	nitrogen
njuean	niuean
nivel	nivel
nivelə	nivelă
niʃte	niște
no	no
nɔː	no
no̯apte	noapte
no̯apte̯a	noaptea
no̯astre	noastre
no̯astrə	noastră
nobil	nobil
nokturn	nocturn
nod	nod
nodos	nodos
noj	noi
nojan	noian
nojembrije	noiembrie
noime	noime
nominal	nominal
nominativ	nominativ
nominative	nominative
nonstop	nonstop
noptierə	noptieră
nord	nord
nordik	nordic
normal	normal
norokos	norocos
norod	norod
norvedʒian	norvegian
norə	noră
nostaldʒik	nostalgic
nostimjor	nostimior
nostru	nostru
notatsie	notație
nowa	noua
nowə	nouă
nowəle̯a	nouălea
nowəsprezetʃe	nouăsprezece
nowəsprezetʃe̯a	nouăsprezecea
nowəsprezetʃele̯a	nouăsprezecelea
nowəzetʃe̯a	nouăzecea
nowəzetʃj	nouăzeci
nowəzetʃile̯a	nouăzecilea
nowəʃpe	nouășpe
nowəʃpe̯a	nouășpea
nowəʃpele̯a	nouășpelea
noʃtri	noștri
nu	nu
nuk	nuc
nutʃj	nuci
nukə	nucă
nudism	nudism
nudist	nudist
nuferj	nuferi
nufər	nufăr
nuɡa	nuga
nujele	nuiele
numaj	numai
numerabilitate	numerabilitate
numerik	numeric
numər	număr
numəra	număra
nunta	nunta
nuntə	nuntă
nuptsial	nupțial
nurkə	nurcă
nutritsionist	nutriționist
nutritsionistə	nutriționistă
nədeʒde	nădejde
nədeʒdj	nădejdi
nədəʒdui	nădăjdui
nəframə	năframă
nəlukə	nălucă
nənəw	nănău
nəpɨrkə	năpârcă
nəpəstuit	năpăstuit
nərtos	nărtos
nəskut	născut
nəsos	năsos
nəsut	năsut
nətərəw	nătărău
nəzbutie	năzbutie
nəzbɨtie	năzbâtie
nəzdrəvan	năzdrăvan
o̯akeʃ	oacheș
o̯aje	oaie
o̯alə	oală
o̯amenj	oameni
o̯are	oare
o̯arekare	oarecare
o̯aretʃe	oarece
o̯arekɨnd	oarecând
o̯arfən	oarfăn
o̯arə	oară
o̯aspete	oaspete
o̯aspetsj	oaspeți
objektiv	obiectiv
oblete	oblete
oblets	obleț
oblik	oblic
obliɡatorju	obligatoriu
obliɡatsie	obligație
oblu	oblu
obositor	obositor
obraznik	obraznic
obrəʒor	obrăjor
obstʃen	obscen
obskur	obscur
observa	observa
observant	observant
obstinatsie	obstinație
obstruktsie	obstrucție
obtsinere	obținere
oka	oca
oktʃident	occident
otʃe̯anoɡraf	oceanograf
otʃe̯anoɡrafə	oceanografă
oke̯an	ochean
oke̯ane	ocheane
okelarj	ochelari
oki	ochi
okj	ochi
oktal	octal
oktant	octant
oktet	octet
oktombrije	octombrie
oktometru	octometru
okupa	ocupa
okupator	ocupator
okupatsie	ocupație
odora	odora
of	of
ofensator	ofensator
ofitʃialə	oficială
ofitʃiː	oficii
ofitʃju	oficiu
ofilit	ofilit
ofta	ofta
oɡlində	oglindă
oɡlinʒo̯arə	oglinjoară
oj	oi
oitsə	oiță
olandezə	olandeză
olimpik	olimpic
oliv	oliv
oloɡ	olog
om	om
oman	oman
omeni	omeni
omenos	omenos
omletə	omletă
omnipotent	omnipotent
omnipotentsə	omnipotență
omniprezent	omniprezent
omniprezentu	omniprezentul
omniprezentul	omniprezentul
omniprezentsa	omniprezența
omniprezentse	omniprezențe
omniprezentsej	omniprezenței
omnistʃient	omniscient
omodʒen	omogen
omor	omor
omu	omul
omul	omul
onkoloɡ	oncolog
onkoloɡə	oncologă
ondulat	ondulat
onest	onest
onirik	oniric
onomatopeik	onomatopeic
operatsie	operație
operatsional	operațional
oposum	oposum
opozitsie	opoziție
opri	opri
opt	opt
opta	opta
optime	optime
optimist	optimist
optsprezetʃe	optsprezece
optsprezetʃe̯a	optsprezecea
optsprezetʃele̯a	optsprezecelea
optule̯a	optulea
obzetʃe̯a	optzecea
optzetʃe̯a	optzecea
obzetʃj	optzeci
optzetʃj	optzeci
obzetʃile̯a	optzecilea
optzetʃile̯a	optzecilea
optʃpe	optșpe
optʃpe̯a	optșpea
optʃpele̯a	optșpelea
opus	opus
opərit	opărit
ora	ora
oralitate	oralitate
oranʒ	oranj
oraʃ	oraș
oraʃe	orașe
oratsie	orație
orb	orb
orbets	orbeț
orcestral	orchestral
orkestrion	orchestrion
ordin	ordin
orfan	orfan
orfik	orfic
orfism	orfism
orɡaniza	organiza
orɡanizare	organizare
orɡanizat	organizat
orɡanizator	organizator
orɡanizatorj	organizatori
orɡanizatorik	organizatoric
orɡanizərj	organizări
orɡolios	orgolios
orj	ori
orjkare	oricare
orjtʃe	orice
orjtʃine	oricine
orjkum	oricum
orjkɨnd	oricând
orjkɨt	oricât
orientare	orientare
orjunde	oriunde
orjʃikɨnd	orișicând
orna	orna
ornat	ornat
ornitoloɡ	ornitolog
ornitoloɡə	ornitologă
ornitorink	ornitorinc
oroɡrafie	orografie
ortodoks	ortodox
ortoɡrafie	ortografie
ortoped	ortoped
ortopedist	ortopedist
ortopedistə	ortopedistă
ortopedə	ortopedă
orətanie	orătanie
ostʃjor	oscior
osos	osos
ostenit	ostenit
ostroɡot	ostrogot
osu	osu
otoman	otoman
otova	otova
otrava	otrava
otravə	otravă
otrəvitor	otrăvitor
awtsajdər	outsider
owə	ouă
oviform	oviform
oksidʒen	oxigen
ozon	ozon
otsel	oțel
p	p
paket	pachet
pakete	pachete
patʃient	pacient
patʃientə	pacientă
paɡodə	pagodă
pahar	pahar
pahare	pahare
pajsprezetʃe	paisprezece
pajsprezetʃe̯a	paisprezecea
pajsprezetʃele̯a	paisprezecelea
pajʃpe	paișpe
pajʃpe̯a	paișpea
pajʃpele̯a	paișpelea
paʒ	paj
paleontoloɡ	paleontolog
paleontoloɡə	paleontologă
palid	palid
palinkə	palincă
paludə	paludă
palə	pală
pamente	pamente
panseksual	pansexual
panteon	panteon
panterə	panteră
pantof	pantof
papaɡal	papagal
papaja	papaia
paparudə	paparudă
papirus	papirus
paradoksu	paradoxul
paradoksul	paradoxul
parafina	parafina
paradʒinə	paragină
paraɡraf	paragraf
paraleloɡram	paralelogram
paralitik	paralitic
paraliza	paraliza
parasol	parasol
parazitar	parazitar
parazitolodʒie	parazitologie
parkurs	parcurs
pardesiw	pardesiu
pardon	pardon
pare	pare
paria	paria
pariw	pariu
paroh	paroh
parte	parte
partitʃipju	participiu
parvenit	parvenit
partsial	parțial
pas	pas
pasadʒer	pasager
pastelist	pastelist
pastor	pastor
pastra	pastra
pasəre	pasăre
pat	pat
patimə	patimă
patinaʒ	patinaj
patinare	patinare
patodʒenezə	patogeneză
patodʒenije	patogenie
patoloɡ	patolog
patolodʒist	patologist
patolodʒistə	patologistă
patoloɡə	patologă
patra	patra
patritʃiat	patriciat
patronaʒ	patronaj
patronit	patronit
patru	patru
patrule̯a	patrulea
patruzetʃe̯a	patruzecea
patruzetʃj	patruzeci
patruzetʃile̯a	patruzecilea
patul	patul
pauzə	pauză
pavaʒ	pavaj
pazə	pază
paʃnik	pașnic
pe	pe
pederastik	pederastic
pedestru	pedestru
pediatru	pediatru
pediatrə	pediatră
pejorativ	peiorativ
pelikan	pelican
penetratsie	penetrație
penibil	penibil
peninsular	peninsular
peninsulə	peninsulă
pensula	pensula
pensulə	pensulă
pentaɡramə	pentagramă
pentametru	pentametru
pentan	pentan
pentatlon	pentatlon
pentatlonist	pentatlonist
pentatlonistə	pentatlonistă
pentru	pentru
penumbrə	penumbră
perfid	perfid
peria	peria
perikol	pericol
perikulos	periculos
peridot	peridot
perie	perie
peristaltik	peristaltic
perlə	perlă
permanente	permanente
permis	permis
permisie	permisie
permisje	permisie
permite	permite
pernele	pernele
pernə	pernă
persan	persan
persekuta	persecuta
perso̯anə	persoană
personaʒ	personaj
perturbator	perturbator
perukier	peruchier
perukə	perucă
peruvian	peruvian
peruʃ	peruș
pervers	pervers
peskos	pescos
peskəre̯askə	pescărească
peskəresk	pescăresc
peskəreʃtj	pescărești
peskəruʃ	pescăruș
pesemne	pesemne
peste	peste
petalə	petală
petitsie	petiție
petrarkist	petrarchist
petrarkistə	petrarchistă
peʃkir	peșchir
peʃte	pește
peʃtele	peștele
peʃtiː	peștii
pfund	pfund
pjatrə	piatră
pjatsə	piață
pika	pica
pikam	picam
pikaw	picau
pitʃo̯are	picioare
pitʃor	picior
pikoɡram	picogram
pikta	picta
piktat	pictat
piktor	pictor
piktoritsə	pictoriță
pikturə	pictură
pikɨnd	picând
pikəm	picăm
pielonefritə	pielonefrită
pjept	piept
pjeptos	pieptos
pjerde	pierde
pjerdut	pierdut
pjersikə	piersică
pjese	piese
pjesə	piesă
pjetritʃikə	pietricică
pjetros	pietros
piɡment	pigment
piʒama	pijama
pilot	pilot
pilota	pilota
pilotaserə	pilotaseră
pilotatsj	pilotați
pilotə	pilotă
pinɡuin	pinguin
piramidə	piramidă
pirik	piric
piron	piron
pirop	pirop
piroksen	piroxen
piroksenit	piroxenit
pisik	pisic
pisikutsə	pisicuță
pisikə	pisică
pisoj	pisoi
pistil	pistil
pitʃipain	pitchpine
pitulitʃe	pitulice
pitura	pitura
pitə	pită
pivnitsə	pivniță
piks	pix
pizdos	pizdos
pizmaʃ	pizmaș
pitsiɡoj	pițigoi
plakə	placă
plaʒə	plajă
planetar	planetar
plasmə	plasmă
plasə	plasă
platonik	platonic
pleka	pleca
plekare	plecare
pleo̯apə	pleoapă
ple̯o̯apə	pleoapă
plesni	plesni
pletorik	pletoric
pleʃuv	pleșuv
pliktikos	plicticos
pliktisitor	plictisitor
plin	plin
plo̯aje	ploaie
plod	plod
ploitʃikə	ploicică
plointe	plointe
plowa	ploua
plumbos	plumbos
plumburiw	plumburiu
plural	plural
plus	plus
pluti	pluti
plutitor	plutitor
plutə	plută
plɨndʒe	plânge
plɨndʒeros	plângeros
plɨns	plâns
plətʃa	plăcea
plətʃere	plăcere
plətʃintə	plăcintă
pləkut	plăcut
plənui	plănui
pləpɨnd	plăpând
pləʃj	plăși
pnew	pneu
po̯arkə	poarcă
po̯artə	poartă
po̯ate	poate
podjum	podium
podoloɡ	podolog
podoloɡə	podologă
poet	poet
poetik	poetic
pofida	pofida
pofidə	pofidă
poftitʃjos	pofticios
poftim	poftim
polar	polar
poliɡam	poligam
poliɡon	poligon
poliɡonal	poligonal
poliptik	poliptic
polisier	polisier
politik	politic
politikos	politicos
politsie	poliție
poloneze	poloneze
pomada	pomada
pomadə	pomadă
pomeni	pomeni
pomenj	pomeni
pompier	pompier
pompə	pompă
pope̯askə	popească
popesk	popesc
popeʃtj	popești
popilnik	popilnic
popor	popor
poporan	poporan
popotə	popotă
popow	popou
popular	popular
populatsie	populație
popə	popă
portʃe̯askə	porcească
portʃesk	porcesc
portʃeʃtj	porcești
portʃin	porcin
porfirie	porfirie
pornake	pornache
pornoɡrafia	pornografia
pornoɡrafik	pornografic
portal	portal
portokaliw	portocaliu
portofel	portofel
portuɡez	portughez
portuɟezə	portugheză
porumbak	porumbac
portsie	porție
portsjune	porțiune
posedare	posedare
posibil	posibil
postdetʃembrist	postdecembrist
potaje	potaie
potasju	potasiu
potekə	potecă
potent	potent
potrivit	potrivit
povestio̯arə	povestioară
poʃirkə	poșircă
poʃtal	poștal
poʃtə	poștă
poʃtəritsə	poștăriță
praktik	practic
praktika	practica
praktitʃian	practician
praf	praf
prafurj	prafuri
prat	prat
pre̯afrumos	preafrumos
preambala	preambala
preambalare	preambalare
preambalat	preambalat
preambalərj	preambalări
prekaut	precaut
pretʃede	precede
pretʃis	precis
prekoniza	preconiza
prekum	precum
preda	preda
prefera	prefera
pɾefiks	prefix
prefiksal	prefixal
prefiksalə	prefixală
predʒet	preget
predʒeta	pregeta
preɡnant	pregnant
preɡəte̯aj	pregăteai
preɡəte̯am	pregăteam
preɡəte̯aw	pregăteau
preɡəte̯atsj	pregăteați
preɡətesk	pregătesc
preɡəteʃtj	pregătești
preɡətim	pregătim
preɡətind	pregătind
preɡətirə	pregătiră
preɡətirəm	pregătirăm
preɡətirətsj	pregătirăți
preɡətise	pregătise
preɡətisem	pregătisem
preɡətiserəm	pregătiserăm
preɡətiserətsj	pregătiserăți
preɡətiseʃj	pregătiseși
preɡətiʃj	pregătiși
preistorik	preistoric
preʒos	prejos
prelukrat	prelucrat
preluda	preluda
preluŋɡ	prelung
prelundʒi	prelungi
prelundʒit	prelungit
preot	preot
preotse̯askə	preoțească
preotsesk	preoțesc
preotseʃtj	preoțești
preputsial	prepuțial
preskrie	prescrie
preskurtare	prescurtare
presimtsire	presimțire
presotʃialist	presocialist
presta	presta
pretentsie	pretenție
pretentsios	pretențios
pretor	pretor
pretorj	pretori
preturj	preturi
preturə	pretură
preuskare	preuscare
prezent	prezent
prezenta	prezenta
prezervativ	prezervativ
prezervativu	prezervativul
prezervativul	prezervativul
pretsios	prețios
pribe̯aɡ	pribeag
pribe̯aɡə	pribeagă
pribedʒi	pribegi
pritʃepe	pricepe
prikindel	prichindel
prjer	prier
prietenu	prietenul
prietenul	prietenul
prim	prim
prima	prima
primar	primar
primeʒdie	primejdie
primeʒdje	primejdie
primeʒdios	primejdios
primi	primi
primj	primi
priməvarə	primăvară
prin	prin
printʃipal	principal
prins	prins
printre	printre
pripi	pripi
prismə	prismă
prispə	prispă
pristol	pristol
privi	privi
priviɡeto̯are	privighetoare
priza	priza
pro̯aspət	proaspăt
probabil	probabil
problematik	problematic
proklamatsie	proclamație
proktoloɡ	proctolog
proktoloɡə	proctologă
produtʃere	producere
produkətor	producător
produkətorj	producători
produktsie	producție
produs	produs
produse	produse
profan	profan
profesor	profesor
profitabil	profitabil
profund	profund
proɡram	program
proɡramabil	programabil
projektil	proiectil
promis	promis
promite	promite
promorar	promorar
promoro̯akə	promoroacă
promova	promova
pronominal	pronominal
pronuntsa	pronunța
pronuntsabil	pronunțabil
pronuntsare	pronunțare
pronuntsie	pronunție
propaɡandə	propagandă
proportsional	proporțional
prospetsime	prospețime
prost	prost
prosti	prosti
prostime	prostime
proton	proton
proverb	proverb
provintʃial	provincial
provintʃie	provincie
prozaik	prozaic
prudent	prudent
prune	prune
prɨnz	prânz
prədui	prădui
prəʒinj	prăjini
prəʒinə	prăjină
prəʒit	prăjit
prəpastie	prăpastie
pseudoʃtiintsə	pseudoștiință
psihiatru	psihiatru
psihiatrə	psihiatră
psihofizitʃian	psihofizician
psihofizitʃianə	psihofiziciană
psiholoɡ	psiholog
psiholoɡə	psihologă
pubertate	pubertate
publik	public
putʃo̯asə	pucioasă
putʃjos	pucios
pudʒilist	pugilist
pudʒilistə	pugilistă
puhoj	puhoi
pulie	pulie
pulos	pulos
pulosu	pulosul
pulosul	pulosul
pulpanə	pulpană
pulpos	pulpos
puls	puls
pulərie	pulărie
pumə	pumă
punkt	punct
pune	pune
pupa	pupa
pupətʃe̯alə	pupăceală
pur	pur
purtʃede	purcede
purɡatoriu̯	purgatoriu
purifikator	purificator
purpuriw	purpuriu
pusew	puseu
pustie	pustie
pustiw	pustiu
pute̯a	putea
putere	putere
puternik	puternic
putred	putred
putrestʃent	putrescent
puturos	puturos
puʃkulitsə	pușculiță
puʃkə	pușcă
puts	puț
putsintel	puțintel
putsinətate	puținătate
pɨjne	pâine
pɨlk	pâlc
pɨne	pâne
pɨntekos	pântecos
pɨnzukə	pânzucă
pɨnzutsə	pânzuță
pɨnə	până
pɨrtie	pârtie
pɨrɨw	pârâu
pɨrɨ	pârî
pəkətos	păcătos
pəduki	păduchi
pədukjos	păduchios
pədure	pădure
pədurets	pădureț
pəduros	păduros
pəɡɨn	păgân
pəj	păi
pəjanʒenu	păianjenul
pəjanʒenul	păianjenul
pəjos	păios
pəlinkə	pălincă
pəmɨntu	pământul
pəmɨntul	pământul
pəpədie	păpădie
pərtinitor	părtinitor
pərəsi	părăsi
pərəsit	părăsit
pəsa	păsa
pəskut	păscut
pəstor	păstor
pəstoritsə	păstoriță
pəstra	păstra
pəstrare	păstrare
pəstrərj	păstrări
pəstrəto̯are	păstrătoare
pəstrətor	păstrător
pəstrətorj	păstrători
pəsəre̯askə	păsărească
pəsəresk	păsăresc
pəsəreʃtj	păsărești
pəsəroj	păsăroi
pətat	pătat
pətlədʒa	pătlăgea
pətlədʒikə	pătlăgică
pətrat	pătrat
pətrime	pătrime
pəun	păun
pəʃune̯alə	pășuneală
pətsi	păți
k	q
rabinik	rabinic
rak	rac
raketə	rachetă
rakiw	rachiu
radar	radar
radiatsie	radiație
radikal	radical
radioaktiv	radioactiv
radioproɡram	radioprogram
rafina	rafina
rafinare	rafinare
rafinat	rafinat
rafinərj	rafinări
raɡanelə	raganelă
raj	rai
ram	ram
ramolit	ramolit
ranɡə	rangă
rapid	rapid
rar	rar
rarə	rară
ras	ras
raton	raton
ravak	ravac
ratsional	rațional
ratsionalizabil	raționalizabil
ratsə	rață
reabilita	reabilita
reambala	reambala
reambalare	reambalare
re̯avən	reavăn
rebeliune	rebeliune
retʃepe	recepe
retʃeptsiona	recepționa
retʃiklat	reciclat
retʃita	recita
retʃiʃor	recișor
rekompensə	recompensă
rekuno̯aʃte	recunoaște
rekuperat	recuperat
redutʃe	reduce
redundant	redundant
redus	redus
referendum	referendum
referintsə	referință
reflektat	reflectat
refuza	refuza
reɡal	regal
reɡalist	regalist
redʒe	rege
redʒe̯askə	regească
redʒesk	regesc
redʒeʃtj	regești
redʒitʃid	regicid
redʒim	regim
redʒiune	regiune
reɡn	regn
reɡula	regula
reɡulat	regulat
reɡulj	reguli
reɡulə	regulă
reɡurdʒita	regurgita
relaksat	relaxat
relatsie	relație
relidʒios	religios
ren	ren
renaʃte	renaște
renumit	renumit
renuntsa	renunța
reparabil	reparabil
repede	repede
repeʒor	repejor
repeta	repeta
repetirui	repetirui
repezitsj	repeziți
repetsi	repeți
repetsj	repeți
replikatsie	replicație
reprezenta	reprezenta
reprobabil	reprobabil
republika	republica
republikə	republică
reputatsie	reputație
reskrie	rescrie
resemna	resemna
respekt	respect
respindʒe	respinge
respiratsie	respirație
rest	rest
retina	retina
retorikə	retorică
retradʒe	retrage
retras	retras
reuʃi	reuși
reveni	reveni
revenj	reveni
rezematsj	rezemați
rezervə	rezervă
rezident	rezident
reziduat	reziduat
rezistibil	rezistibil
rezulta	rezulta
rezultat	rezultat
rezultate	rezultate
reɨnto̯artʃe	reîntoarce
reʃedintsə	reședință
retse̯a	rețea
retsine	reține
rid	rid
ridika	ridica
ridikat	ridicat
riɡlə	riglă
riɡə	rigă
risk	risc
riskurj	riscuri
riveran	riveran
ro̯atə	roată
rob	rob
rojb	roib
roman	roman
romantʃier	romancier
romb	romb
rombik	rombic
romɨn	român
romɨnesk	românesc
romɨneʃte	românește
romɨneʃtilor	româneștilor
ros	ros
rotatsie	rotație
rotokol	rotocol
rotund	rotund
rotunʒime	rotunjime
rotunʒit	rotunjit
roz	roz
roziʃor	rozișor
rozə	roză
rozətor	rozător
roʃkat	roșcat
roʃie	roșie
roʃje	roșie
roʃu	roșu
ruɡa	ruga
rudʒiniw	ruginiu
ruina	ruina
ruinare	ruinare
ruʒ	ruj
rumeɡuʃ	rumeguș
rumeɡətor	rumegător
rumejor	rumeior
rumeor	rumeor
rumɨnesk	rumânesc
runde	runde
rundə	rundă
rupt	rupt
rus	rus
rustʃism	ruscism
ruse	ruse
rusə	rusă
rutə	rută
ruʃina	rușina
ruʃinat	rușinat
ruʃinos	rușinos
rɨde	râde
rɨjos	râios
rɨmlene̯askə	râmlenească
rɨmlenesk	râmlenesc
rɨmleneʃtj	râmlenești
rɨŋkatʃj	râncaci
rɨntʃed	rânced
rɨnd	rând
rɨntaʃ	rântaș
rɨnzə	rânză
rɨnə	rână
rɨpos	râpos
rɨs	râs
rɨw	râu
rɨuri	râuri
rɨurj	râuri
rɨvni	râvni
rɨvnə	râvnă
rəbdətor	răbdător
rətʃe̯alə	răceală
rəkni	răcni
rəko̯are	răcoare
rədʒet	răget
rəɡuʃe̯alə	răgușeală
rəɡuʃit	răgușit
rəmas	rămas
rəmaʃj	rămași
rəmuros	rămuros
rəptʃune	răpciune
rəpitor	răpitor
rəposat	răposat
rəpənos	răpănos
rəsfətsa	răsfăța
rəsfətsat	răsfățat
rəspikat	răspicat
rəspunde	răspunde
rəsunətor	răsunător
rəszitʃe	răszice
rətətʃit	rătăcit
rəw	rău
rəwfəkətor	răufăcător
rəutətʃjos	răutăcios
rəzbate	răzbate
rəzbel	răzbel
rəzbuna	răzbuna
rəzbunətor	răzbunător
rəzlets	răzleț
rəʃinos	rășinos
rətsoj	rățoi
s	s
sa	sa
sak	sac
sakrament	sacrament
sakristan	sacristan
sal	sal
saːl	sal
salam	salam
salamandrə	salamandră
salamurə	salamură
salariat	salariat
saltʃie	salcie
sale	sale
salivə	salivă
salt	salt
salut	salut
saluta	saluta
salva	salva
salve	salve
samoan	samoan
saŋktuar	sanctuar
sanie	sanie
sapient	sapient
saponifika	saponifica
sarafan	sarafan
saramurə	saramură
sardoniks	sardonix
sare	sare
satin	satin
satirə	satiră
satisfəkut	satisfăcut
satisfəkətor	satisfăcător
satɨr	satâr
saudit	saudit
savura	savura
sakson	saxon
saʃiw	sașiu
skaba	scaba
skandal	scandal
skandju	scandiu
skepsis	schepsis
skilod	schilod
skilodi	schilodi
skimb	schimb
skimba	schimba
skior	schior
stʃit	scit
sklave	sclave
sklavj	sclavi
sklavə	sclavă
sko̯artsə	scoarță
sko̯ate	scoate
skotʃorɨ	scociorî
skojtʃj	scoici
skojkə	scoică
skorni	scorni
skorpjon	scorpion
skortsiʃo̯arə	scorțișoară
skotsian	scoțian
skriito̯are	scriitoare
skriitor	scriitor
skrimer	scrimer
skriw	scriu
skro̯afə	scroafă
skrotalu	scrotalul
skrotalul	scrotalul
skufundat	scufundat
skujpat	scuipat
skula	scula
skulptat	sculptat
skump	scump
skumpuʃor	scumpușor
skund	scund
skurt	scurt
skurtiʃor	scurtișor
skutek	scutec
skɨnteje	scânteie
skɨrbos	scârbos
skəldat	scăldat
skəmos	scămos
skəmoʃa	scămoșa
skəpa	scăpa
se	se
se̯ara	seara
se̯arbəd	searbăd
se̯arə	seară
sek	sec
setʃetə	secetă
sekol	secol
sekret	secret
sekretariat	secretariat
sekretsie	secreție
sekundar	secundar
sekventsial	secvențial
seda	seda
sefard	sefard
seismoloɡ	seismolog
seismoloɡə	seismologă
selenju	seleniu
semafor	semafor
semitʃerk	semicerc
seminifer	seminifer
semiotitʃian	semiotician
semiotitʃianə	semioticiană
semn	semn
semnare	semnare
semnat	semnat
semnifikatsie	semnificație
senin	senin
sentiment	sentiment
separa	separa
sept	sept
septembrije	septembrie
septenar	septenar
ser	ser
serinɡə	seringă
serios	serios
serval	serval
servitʃiː	servicii
servitʃju	serviciu
serviete	serviete
servietə	servietă
servus	servus
sesiune	sesiune
set	set
sete	sete
sete̯a	setea
setos	setos
seks	sex
seksadʒesimal	sexagesimal
seksolodʒia	sexologia
seksos	sexos
sekstinə	sextină
sfat	sfat
sferik	sferic
sfintsenie	sfințenie
sfintsenje	sfințenie
sforəji	sforăi
sfɨrɨi	sfârâi
sfɨrʃitu	sfârșitul
sfɨrʃitul	sfârșitul
sfərɨmitʃjos	sfărâmicios
si	si
siberian	siberian
sikriw	sicriu
siktir	sictir
sɨktir	sictir
sie	sie
sieʃj	sieși
siɡur	sigur
siɡuritate	siguritate
sihlə	sihlă
silabik	silabic
silitʃjos	silicios
silitʃju	siliciu
silintsə	silință
silvə	silvă
simbol	simbol
simetrik	simetric
simt	simt
simula	simula
simulakru	simulacru
simun	simun
simtsire	simțire
sintʃer	sincer
sine	sine
sinerdʒie	sinergie
sinɡular	singular
sinɡur	singur
siŋɡuratek	singuratec
siŋɡuratik	singuratic
sinistru	sinistru
sinonim	sinonim
sintaɡmə	sintagmă
sinteze	sinteze
sintezə	sinteză
sinutʃidere	sinucidere
sipet	sipet
sirian	sirian
sirop	sirop
siropurj	siropuri
sistem	sistem
sajt	site
situatsie	situație
situatsional	situațional
situlə	situlă
skandənberɡ	skandenberg
slenɡ	slang
sleʃ	slash
slav	slav
slavə	slavă
slobod	slobod
sluɡarnik	slugarnic
slut	slut
slutiʃor	slutișor
slutsior	sluțior
sləbənoɡ	slăbănog
smokinə	smochină
so̯akrə	soacră
so̯are	soare
so̯arele	soarele
sobol	sobol
sok	soc
sotʃial	social
sotʃialism	socialism
sotʃioloɡ	sociolog
sotʃioloɡə	sociologă
sokotit	socotit
socru	socru
sodju	sodiu
sodomizatu	sodomizatul
sodomizatul	sodomizatul
sofistikat	sofisticat
sofra	sofra
soja	soia
solan	solan
solar	solar
solemn	solemn
solid	solid
solstitsiu̯	solstițiu
solz	solz
solzos	solzos
somat	somat
somn	somn
somnambulism	somnambulism
somnoros	somnoros
somon	somon
sonetist	sonetist
soporifik	soporific
sora	sora
sorbet	sorbet
sorbi	sorbi
sorij	sorii
sorə	soră
sos	sos
sosi	sosi
sosnar	sosnar
sotnik	sotnic
soviet	soviet
sotsije	soție
sotsio̯arə	soțioară
sotsior	soțior
sotsu	soțul
sotsul	soțul
spam	spam
spaniol	spaniol
spaniolj	spanioli
spaniolə	spaniolă
spardʒe	sparge
spardʒere	spargere
spart	spart
spartsj	sparți
spate	spate
spatulə	spatulă
spetʃie	specie
spetʃifik	specific
spera	spera
sperantsa	speranța
sperantsə	speranță
sperare	sperare
speria	speria
sperja	speria
speriat	speriat
sperieto̯are	sperietoare
spermatik	spermatic
spermatodʒen	spermatogen
spermatodʒenezə	spermatogeneză
spinos	spinos
spirit	spirit
spiritual	spiritual
spornik	spornic
sprej	spray
ʃprej	spray
spre	spre
spriʒin	sprijin
spriʒini	sprijini
sprintejor	sprinteior
sprinten	sprinten
spumos	spumos
spumə	spumă
spun	spun
spune	spune
spurkat	spurcat
spus	spus
spusə	spusă
spusətʃune	spusăciune
spuze̯alə	spuzeală
spɨn	spân
spəla	spăla
spəlare	spălare
spələtor	spălător
spətos	spătos
sta	sta
stabil	stabil
stadju	stadiu
stadʒju	stagiu
stadʒune	stagiune
staɡnant	stagnant
stanifer	stanifer
stat	stat
statistik	statistic
statistitʃian	statistician
statistitʃianə	statisticiană
statuje	statuie
staw	stau
statsie	stație
ste̯a	stea
ste̯awa	steaua
stej	stei
steʒar	stejar
stelat	stelat
stele	stele
stenoɡraf	stenograf
sterp	sterp
stetoskop	stetoscop
stih	stih
stihar	stihar
stil	stil
stima	stima
stiŋɡer	stingher
stipula	stipula
sto̯artʃe	stoarce
strakinə	strachină
stradə	stradă
straj	strai
stranju	straniu
strekurəto̯are	strecurătoare
stria	stria
strikat	stricat
striɡa	striga
striɡare	strigare
striɡat	strigat
striɡoj	strigoi
striɡoime	strigoime
striɡət	strigăt
striɡətor	strigător
strofə	strofă
strop	strop
stropi	stropi
struktural	structural
strukturat	structurat
st̪ɾuɡuɾe	strugure
struts	struț
strɨmb	strâmb
strɨmt	strâmt
strɨmto̯are	strâmtoare
strɨmtorj	strâmtori
strɨŋɡətor	strângător
strəbunik	străbunic
strədanie	strădanie
strəfuldʒerare	străfulgerare
strəin	străin
strəlutʃitor	strălucitor
strənepot	strănepot
strəvekj	străvechi
strəvezime	străvezime
strəveziw	străveziu
studentə	studentă
studio	studio
studjo	studio
stufos	stufos
stupi	stupi
stupj	stupi
stupid	stupid
stupinə	stupină
stɨnkə	stâncă
stɨŋɡ	stâng
stɨnɡatʃj	stângaci
stɨnɡətʃie	stângăcie
stɨrk	stârc
stəpɨnitor	stăpânitor
stəpɨnə	stăpână
stərui	stărui
stəruitor	stăruitor
sub	sub
submarin	submarin
subsonik	subsonic
substantiv	substantiv
substantsial	substanțial
subteran	subteran
subtil	subtil
subtropikal	subtropical
suburban	suburban
subtsior	subțior
subtsire	subțire
subtsirel	subțirel
suk	suc
suktʃedare	succedare
suktʃedere	succedere
sutʃi	suci
sudik	sudic
sudo̯are	sudoare
suedeze	suedeze
sufitʃient	suficient
sufletu	sufletul
sufletul	sufletul
sufletsel	suflețel
suɡatʃj	sugaci
suɡar	sugar
sudʒe	suge
sui	sui
sulk	sulc
suledʒet	suleget
suledʒete	sulegete
sulf	sulf
sulfurik	sulfuric
sulfuros	sulfuros
sultan	sultan
sultanat	sultanat
sulə	sulă
suna	suna
sunt	sunt
sɨnt	sunt
sunətor	sunător
supapə	supapă
superior	superior
suplu	suplu
supozitsie	supoziție
supraindustrializat	supraindustrializat
supranatsional	supranațional
supranumit	supranumit
supravjetsui	supraviețui
suprem	suprem
sur	sur
surd	surd
sure	sure
suriʃor	surișor
surprinzətor	surprinzător
surɨde	surâde
surɨs	surâs
sustʃeptibil	susceptibil
sustʃita	suscita
suspensor	suspensor
susura	susura
sustsine	susține
suta	suta
sute	sute
sutime	sutime
sutəle̯a	sutălea
sɨmbete	sâmbete
sɨmbrə	sâmbră
sɨmbətə	sâmbătă
sɨn	sân
sɨndʒe	sânge
sɨndʒele	sângele
sɨndʒera	sângera
sɨndʒerete	sângerete
sɨndʒeriw	sângeriu
sɨnt	sânt
sɨrb	sârb
sɨrbotej	sârbotei
sɨrɡuintʃjos	sârguincios
sə	să
səbləzni	săblăzni
səkret	săcret
səltʃiw	sălciu
səltərets	săltăreț
səmɨntsos	sămânțos
səpa	săpa
səptəmɨnal	săptămânal
səpunjerə	săpunieră
sərat	sărat
səri	sări
sərj	sări
sərman	sărman
sərsam	sărsam
səruta	săruta
sərute	sărute
sərəmurə	sărămură
sətul	sătul
səturat	săturat
səw	său
səvɨrʃire	săvârșire
səvɨrʃirj	săvârșiri
t	t
ta	ta
tatʃit	tacit
tahitian	tahitian
tajkə	taică
tajnik	tainic
talamus	talamus
taltʃjok	talcioc
tamarin	tamarin
tanaʒ	tanaj
tandru	tandru
tanti	tanti
tantj	tanti
tanzanian	tanzanian
tapa	tapa
tapeta	tapeta
taraf	taraf
tarantulə	tarantulă
tardiɡrad	tardigrad
tare	tare
tarhon	tarhon
tarot	tarot
tatu	tatu
tatuaʒ	tatuaj
tawrin	taurin
tavan	tavan
taksi	taxi
te	te
tehnetsju	technețiu
tehnik	tehnic
tehnikə	tehnică
tehnolodʒik	tehnologic
teinə	teină
telur	telur
tembel	tembel
teme	teme
temj	temi
temnitsə	temniță
temperaturə	temperatură
temporar	temporar
temətor	temător
tendintsə	tendință
tendon	tendon
tenisman	tenisman
tenismanə	tenismană
tenta	tenta
tentatsie	tentație
teodolit	teodolit
teoretik	teoretic
teorik	teoric
terapeutik	terapeutic
teren	teren
terestru	terestru
termal	termal
termin	termin
termina	termina
terminaj	terminai
terminam	terminam
terminatsie	terminație
terminatsje	terminație
terminj	termini
terts	terț
tertsiw	terțiu
testa	testa
testament	testament
testikular	testicular
testikulu	testiculul
testikulul	testiculul
tetrametru	tetrametru
tetrasilabik	tetrasilabic
teurdʒie	teurgie
tibetan	tibetan
tibiʃir	tibișir
tikəi	ticăi
tikəlos	ticălos
tiɡru	tigru
tiɡvə	tigvă
tildə	tildă
timid	timid
timiʃore̯an	timișorean
timonier	timonier
timpurj	timpuri
timpuriw	timpuriu
tine	tine
tineret	tineret
tini	tini
tins	tins
tip	tip
tipa	tipa
tipar	tipar
tipare	tipare
tipə	tipă
tiramisu	tiramisu
tisə	tisă
titan	titan
to̯amna	toamna
to̯amnə	toamnă
to̯artʃe	toarce
to̯ate	toate
to̯atə	toată
tobə	tobă
tok	toc
tokat	tocat
totʃe̯alə	toceală
totʃilar	tocilar
totʃit	tocit
tokətor	tocător
tomatə	tomată
tomnatik	tomnatic
toŋɡan	tongan
tont	tont
top	top
toratʃe	torace
tortura	tortura
torturə	tortură
tos	tos
tot	tot
totul	totul
tovərəʃe̯askə	tovărășească
tovərəʃesk	tovărășesc
tovərəʃeʃte	tovărășește
tovərəʃeʃtj	tovărășești
toksik	toxic
totsi	toți
trakatrukə	tracatrucă
traktir	tractir
traditsie	tradiție
tradutʃe	traduce
tradutʃerj	traduceri
traduktor	traductor
tradʒe	trage
traj	trai
trajektorie̯	traiectorie
trajnik	trainic
tramvaj	tramvai
tramversare	tramversare
trandafiriw	trandafiriu
transatlantik	transatlantic
transtʃedental	transcendental
transkontinental	transcontinental
transkrie	transcrie
transotʃe̯anik	transoceanic
transparent	transparent
transpiratsie	transpirație
transpune	transpune
transpunere	transpunere
tranzient	tranzient
tranzitiv	tranzitiv
tranzitoriu̯	tranzitoriu
tranzitsie	tranziție
tranzitsional	tranzițional
trata	trata
tratament	tratament
tratat	tratat
traversa	traversa
traversare	traversare
tre̯abə	treabă
trebui	trebui
trebuintsə	trebuință
tretʃe	trece
tretʃere	trecere
tretʃerj	treceri
trekut	trecut
trekəto̯are	trecătoare
trekətor	trecător
trekətorj	trecători
trej	trei
treja	treia
trejle̯a	treilea
trejsprezetʃe	treisprezece
trejsprezetʃe̯a	treisprezecea
trejsprezetʃele̯a	treisprezecelea
trejzetʃe̯a	treizecea
trejzetʃj	treizeci
trejzetʃile̯a	treizecilea
trejʃpe	treișpe
trejʃpe̯a	treișpea
trejʃpele̯a	treișpelea
tren	tren
tretior	tretior
trianɡlu	trianglu
triatlonist	triatlonist
triatlonistə	triatlonistă
tribal	tribal
tridimensional	tridimensional
triɡlif	triglif
triɡon	trigon
trimaran	trimaran
trimetru	trimetru
trinidadian	trinidadian
triolet	triolet
triptik	triptic
trist	trist
triton	triton
trivial	trivial
triʃa	trișa
trompetə	trompetă
tron	tron
tropik	tropic
trota	trota
trudit	trudit
trudə	trudă
trup	trup
trɨnd	trând
trɨndav	trândav
trɨntit	trântit
trɨntor	trântor
trədare	trădare
trəɡətor	trăgător
trəsnit	trăsnit
trəsəturə	trăsătură
tu	tu
tukan	tucan
tulbure	tulbure
tunɡsten	tungsten
tunisian	tunisian
tuns	tuns
turk	turc
turtʃeʃte	turcește
turistik	turistic
turkmen	turkmen
turmə	turmă
turn	turn
tutela	tutela
tutui	tutui
tuvaluan	tuvaluan
tuʃi	tuși
tɨmp	tâmp
tɨmpenie	tâmpenie
tɨmpit	tâmpit
tɨrsɨnə	târsână
tɨrziw	târziu
təbərɨ	tăbărî
təkut	tăcut
təj	tăi
təjos	tăios
təmədui	tămădui
tərie	tărie
təriʃor	tărișor
tət	tăt
tətik	tătic
təw	tău
u	u
ubikuitətsi	ubicuității
ubikuu	ubicuu
ubikuː	ubicuu
ubikuu	ubicuul
ubikuul	ubicuul
utʃide	ucide
utʃiɡətor	ucigător
ud	ud
udat	udat
udmurt	udmurt
ujmi	uimi
ujtuk	uituc
ulej	ulei
ulm	ulm
ultim	ultim
uman	uman
umbelə	umbelă
umbrelə	umbrelă
umbros	umbros
umbrə	umbră
umed	umed
umeze̯alə	umezeală
umezire	umezire
umezirj	umeziri
umfla	umfla
umil	umil
umili	umili
umilintsə	umilință
umilitate	umilitate
umple	umple
umplere	umplere
umplerj	umpleri
umplut	umplut
un	un
una	una
uŋkj	unchi
undeva	undeva
unditsə	undiță
undre̯a	undrea
undujos	unduios
undə	undă
une̯altə	unealtă
unej	unei
uneorj	uneori
unɡj	unghi
uŋɡje	unghie
uŋɡure̯an	ungurean
uŋɡure̯askə	ungurească
uŋɡurenj	ungureni
uŋɡuresk	unguresc
uŋɡureʃte	ungurește
uŋɡureʃtj	ungurești
uni	uni
unidirektsional	unidirecțional
uniform	uniform
unilateral	unilateral
unire	unire
unor	unor
umpika	unpica
unsprezetʃe	unsprezece
unsprezetʃe̯a	unsprezecea
unsprezetʃele̯a	unsprezecelea
unsuros	unsuros
untar	untar
untos	untos
unturə	untură
unu	unu
unuj	unui
unʃpe	unșpe
unʃpe̯a	unșpea
unʃpele̯a	unșpelea
ura	ura
uraɡan	uragan
urka	urca
urkare	urcare
urkat	urcat
urkuʃ	urcuș
ureke	ureche
uriaʃ	uriaș
urina	urina
urinə	urină
urla	urla
urlare	urlare
urlet	urlet
urmaʃ	urmaș
urmə	urmă
urməri	urmări
urmətor	următor
urni	urni
uroloɡ	urolog
uroloɡə	urologă
ursito̯are	ursitoare
uruɡwajan	uruguayan
urze̯alə	urzeală
urzikə	urzică
urɨt	urât
urɨtsenie	urâțenie
urɨ	urî
urəʃte	urăște
uskat	uscat
ustensilə	ustensilă
ustura	ustura
usturime	usturime
usturətor	usturător
util	util
utila	utila
utilaʒ	utilaj
utile	utile
utilj	utili
utiliza	utiliza
utilizabil	utilizabil
utilizator	utilizator
uzj	uzi
uzinə	uzină
uʃj	uși
uʃor	ușor
uʃurintsə	ușurință
uʃə	ușă
v	v
vakə	vacă
vad	vad
vaɡ	vag
vaɡabond	vagabond
vadʒinal	vaginal
vaj	vai
valabil	valabil
valah	valah
valid	valid
valiza	valiza
valizə	valiză
valo̯are	valoare
valon	valon
valoros	valoros
vamal	vamal
vamə	vamă
van	van
vanadju	vanadiu
vanilie	vanilie
vanitos	vanitos
vapor	vapor
vara	vara
varia	varia
variat	variat
varə	vară
vazə	vază
veke	veche
vekj	vechi
vetʃin	vecin
vetʃinj	vecini
vetʃinə	vecină
vede̯a	vedea
vedenie	vedenie
vedere	vedere
vedʒetal	vegetal
vedʒetatsie	vegetație
velin	velin
venera	venera
venerare	venerare
veneratsie	venerație
venerik	veneric
venezuele̯an	venezuelean
veni	veni
venin	venin
venit	venit
ventilatsie	ventilație
venə	venă
verandə	verandă
verbinə	verbină
verde	verde
verɡur	vergur
verɡurə	vergură
verj	veri
veriʃo̯arə	verișoară
vermijon	vermillon
vermijɔ̃	vermillon
vermut	vermut
verosimil	verosimil
versatile	versatile
versatilj	versatili
versifika	versifica
verteks	vertex
verzuj	verzui
vesel	vesel
veste	veste
vestit	vestit
vezj	vezi
veʃmɨnt	veșmânt
via	via
vjatsa	viața
vjatsə	viață
vikle̯an	viclean
viklenie	viclenie
viklenij	viclenii
viktimə	victimă
viktorios	victorios
vid	vid
vidrə	vidră
vie	vie
vier	vier
vjer	vier
vjermənos	viermănos
vietate	vietate
vietətsj	vietăți
vjetsile	viețile
vjetsui	viețui
viɡware	vigoare
viɡuros	viguros
vij	vii
viij	viii
viitor	viitor
viitorime	viitorime
viiturə	viitură
vinats	vinaț
vintʃe	vince
vintʃibil	vincibil
vindeka	vindeca
vindekətor	vindecător
vindikativ	vindicativ
vine	vine
vinerj	vineri
vinitʃer	vinicer
vinil	vinil
vinoɡrad	vinograd
vinos	vinos
vinovat	vinovat
vinə	vină
vioj	vioi
viol	viol
viola	viola
violent	violent
violet	violet
viperə	viperă
vipt	vipt
viral	viral
virdʒin	virgin
virdʒinal	virginal
virdʒinə	virgină
viril	viril
virile	virile
virilitate̯a	virilitatea
virilitətsi	virilității
virnants	virnanț
viroloɡ	virolog
viroloɡə	virologă
virotik	virotic
virozə	viroză
virtuos	virtuos
virus	virus
visare	visare
viskozitate	viscozitate
vitaminə	vitamină
vite̯az	viteaz
vitezə	viteză
vitikultor	viticultor
vitreɡ	vitreg
vitrinə	vitrină
vitə	vită
viw	viu
vizibil	vizibil
vizitiw	vizitiu
viʃin	vișin
viʃinə	vișină
vitsə	viță
vlaɡə	vlagă
vloɡər	vlogger
vləstar	vlăstar
vo̯astre	voastre
votʃe	voce
votʃe̯a	vocea
voje	voie
vojnik	voinic
vointsə	voință
vojos	voios
volburə	volbură
vo̞ltaʒ	voltaj
voma	voma
vomə	vomă
vopsi	vopsi
vopsitor	vopsitor
vor	vor
vorbe̯aw	vorbeau
vorbeʃte	vorbește
vorbi	vorbi
vorbitor	vorbitor
vorbə	vorbă
vorbərets	vorbăreț
vorteks	vortex
vostru	vostru
vowə	vouă
voʃtri	voștri
vraʒə	vrajă
vre̯a	vrea
vre̯aw	vreau
vrednik	vrednic
vremelnik	vremelnic
vre̯o	vreo
vreun	vreun
vre̯un	vreun
vro	vro
vrun	vrun
vrut	vrut
vrəbioj	vrăbioi
vrəʒitor	vrăjitor
vui	vui
vulkan	vulcan
vulkanoloɡ	vulcanolog
vulkanoloɡə	vulcanologă
vulɡar	vulgar
vulnerabil	vulnerabil
vulnerabilitate	vulnerabilitate
vɨltʃed	vâlced
vɨnat	vânat
vɨnʒos	vânjos
vɨnos	vânos
vɨntos	vântos
vɨnə	vână
vɨnət	vânăt
vɨnətor	vânător
vɨnətorj	vânători
vɨnətə	vânătă
vɨrf	vârf
vɨrtos	vârtos
vɨskos	vâscos
vɨskozitate	vâscozitate
və	vă
vəkar	văcar
vəkarj	văcari
vəkəritsə	văcăriță
vədos	vădos
vəduv	văduv
vəduvə	văduvă
vəij	văii
vəile	văile
vər	văr
vəratik	văratic
vərɡat	vărgat
vərui	vărui
vətraj	vătrai
vəzutsj	văzuți
u	w
v	w
w	w
ujkend	weekend
wikend	weekend
ujski	whisky
wiski	whisky
ks	x
ɡz	x
ksilolodʒie	xilologie
z	z
zadar	zadar
zadarnik	zadarnic
zahər	zahăr
zahəru	zahărul
zahərul	zahărul
zambian	zambian
zare	zare
zarf	zarf
zariʃte	zariște
zarzam	zarzam
zarzavadʒwai̯kə	zarzavagioaică
zarzavadʒiw	zarzavagiu
zarzərə	zarzără
zbate	zbate
zbitʃi	zbici
zbjera	zbiera
zbjerat	zbierat
zboru	zborul
zborul	zborul
zbura	zbura
zdravən	zdravăn
zdruntʃina	zdruncina
zdrənɡəni	zdrăngăni
ze̯amə	zeamă
zebrə	zebră
zetʃe	zece
zetʃe̯a	zecea
zetʃele̯a	zecelea
zetʃj	zeci
zetʃimal	zecimal
zetʃime	zecime
zeitsə	zeiță
zemos	zemos
zer	zer
zero	zero
zevzek	zevzec
zɡlobior	zglobior
zɡomotos	zgomotos
zɡɨltsɨi	zgâlțâi
zɡɨrtʃit	zgârcit
zɡəw	zgău
zɡəurj	zgăuri
zi	zi
ziarist	ziarist
zibelinə	zibelină
zikalə	zicală
zitʃe	zice
zikə	zică
ziɡot	zigot
zimbru	zimbru
zink	zinc
zirkon	zircon
zirkonitə	zirconită
zmeurə	zmeură
zodiakal	zodiacal
zooloɡ	zoolog
zooloɡə	zoologă
zoonomie	zoonomie
zorj	zori
zuɡrəvi	zugrăvi
zvelt	zvelt
zvon	zvon
zvəpəjat	zvăpăiat
zɨmbet	zâmbet
zɨmbi	zâmbi
zɨrnə	zârnă
zɨzanie	zâzanie
zəbalə	zăbală
zəɡan	zăgan
zənatik	zănatic
zəpətʃe̯alə	zăpăceală
zəpətʃit	zăpăcit
zəw	zău
ɨ	â
ɨ	î
ɨntorkətoru	întorcătoru
ɨntunerik	întuneric
ɨ	â
ɨ	î
ɨl	îl
ɨmbelʃuɡat	îmbelșugat
ɨmbietor	îmbietor
ɨmbolnəvi	îmbolnăvi
ɨmbrəka	îmbrăca
ɨmbukəturə	îmbucătură
ɨmbətat	îmbătat
ɨmbətrɨni	îmbătrâni
ɨmbətrɨnit	îmbătrânit
ɨmbətətor	îmbătător
ɨmj	îmi
ɨmpaketa	împacheta
ɨmpindʒe	împinge
ɨmpodobi	împodobi
ɨmpreʒur	împrejur
ɨmpreʒura	împrejura
ɨmpreʒurare	împrejurare
ɨmpreʒurərj	împrejurări
ɨmpreuna	împreuna
ɨmpreunə	împreună
ɨmputsit	împuțit
ɨmpəka	împăca
ɨmpəjenʒeni	împăienjeni
ɨmpərat	împărat
ɨmpərətesk	împărătesc
ɨmpərəteʃte	împărătește
ɨmpərətsie	împărăție
ɨn	în
ɨnainte	înainte
ɨnalt	înalt
ɨnapoj	înapoi
ɨnavutsi	înavuți
ɨnkartʃera	încarcera
ɨntʃeput	început
ɨntʃerka	încerca
ɨntʃerkare	încercare
ɨntʃet	încet
ɨntʃeta	înceta
ɨntʃetiʃor	încetișor
ɨnkina	închina
ɨŋcinətor	închinător
ɨŋkis	închis
ɨnkiso̯are	închisoare
ɨntʃins	încins
ɨnkolo	încolo
ɨnkorona	încorona
ɨnkrede	încrede
ɨnkredere	încredere
ɨnkredere̯a	încrederea
ɨnkrederj	încrederi
ɨnkrederij	încrederii
ɨnkremeni	încremeni
ɨnkrezətor	încrezător
ɨnkrutʃiʃa	încrucișa
ɨnkuja	încuia
ɨnkumeta	încumeta
ɨnkumetə	încumetă
ɨnkurka	încurca
ɨnkɨntətor	încântător
ɨnkɨt	încât
ɨnkə	încă
ɨnkəpe̯a	încăpea
ɨnkəpətor	încăpător
ɨŋkəpətsɨnat	încăpățânat
ɨnkətuʃa	încătușa
ɨndatə	îndată
ɨndeaʒuns	îndeajuns
ɨndemna	îndemna
ɨndeosebj	îndeosebi
ɨndepərta	îndepărta
ɨndepərtat	îndepărtat
ɨndobitotʃi	îndobitoci
ɨndoi	îndoi
ɨndoj	îndoi
ɨndojalə	îndoială
ɨndojelnik	îndoielnic
ɨndoit	îndoit
ɨndoiturə	îndoitură
ɨndopa	îndopa
ɨndrepta	îndrepta
ɨndrəɡosti	îndrăgosti
ɨndrəznets	îndrăzneț
ɨndura	îndura
ɨndərətnik	îndărătnic
ɨnfiɡərets	înfigăreț
ɨnfipt	înfipt
ɨnflori	înflori
ɨnfloritor	înfloritor
ɨnfokat	înfocat
ɨnfometa	înfometa
ɨnfrikoʃa	înfricoșa
ɨnfrumusetsa	înfrumuseța
ɨnfrumusetsare	înfrumusețare
ɨnfrɨna	înfrâna
ɨnfrɨndʒe	înfrânge
ɨnfəʃa	înfășa
ɨnfəʃura	înfășura
ɨnfətsiʃare	înfățișare
ɨndʒer	înger
ɨndʒere̯askə	îngerească
ɨndʒeresk	îngeresc
ɨndʒereʃte	îngerește
ɨndʒereʃtj	îngerești
ɨnɡetsa	îngheța
ɨŋɟetsat	înghețat
ɨnɡitsi	înghiți
ɨnɡitsiturə	înghițitură
ɨŋɡriʒit	îngrijit
ɨnɡriʒorətor	îngrijorător
ɨnɡropətʃune	îngropăciune
ɨŋɡrozitor	îngrozitor
ɨŋɡust	îngust
ɨŋɡɨmfat	îngâmfat
ɨnʒosi	înjosi
ɨnʒumətətsi	înjumătăți
ɨnləkrimat	înlăcrimat
ɨnotətor	înotător
ɨnotətorj	înotători
ɨnroʃit	înroșit
ɨnrɨuri	înrâuri
ɨnrədətʃina	înrădăcina
ɨnsemna	însemna
ɨnsemnətate	însemnătate
ɨnsorit	însorit
ɨnsotsi	însoți
ɨnspre	înspre
ɨnstelat	înstelat
ɨnstrəinare	înstrăinare
ɨnsə	însă
ɨnsəmɨntsa	însămânța
ɨnsənətoʃi	însănătoși
ɨnsərtʃinat	însărcinat
ɨnsərtʃinatə	însărcinată
ɨntemeja	întemeia
ɨntemejere	întemeiere
ɨntemejetor	întemeietor
ɨntineri	întineri
ɨntins	întins
ɨntinsa	întinsa
ɨntinse	întinse
ɨntinsul	întinsul
ɨntinsə	întinsă
ɨntinʃj	întinși
ɨnto̯artʃe	întoarce
ɨntorkətor	întorcător
ɨntors	întors
ɨntort	întort
ɨntre	între
ɨntre̯aɡə	întreagă
ɨntrebuintsa	întrebuința
ɨntretʃere	întrecere
ɨntreɡ	întreg
ɨntredʒime	întregime
ɨntreprinde	întreprinde
ɨntreprindere	întreprindere
ɨntreprinderj	întreprinderi
ɨntrista	întrista
ɨntru	întru
ɨntrukɨt	întrucât
ɨntrukɨtva	întrucâtva
ɨntunekat	întunecat
ɨntunerik	întuneric
ɨntɨj	întâi
ɨntɨjetate	întâietate
ɨntɨjetətsj	întâietăți
ɨntɨlni	întâlni
ɨntɨmplat	întâmplat
ɨntɨrziere	întârziere
ɨnuntru	înuntru
ɨnvekit	învechit
ɨnveli	înveli
ɨnveliʃ	înveliș
ɨnveliʃurj	învelișuri
ɨnveninat	înveninat
ɨnveʃmɨnta	înveșmânta
ɨnvindʒe	învinge
ɨnviŋɡətor	învingător
ɨnvins	învins
ɨnvoi	învoi
ɨnvolt	învolt
ɨnvɨrt	învârt
ɨnvətsat	învățat
ɨnzetʃi	înzeci
ɨnzestrat	înzestrat
ɨnəltsətor	înălțător
ɨnʃtiintsa	înștiința
ɨntseledʒe	înțelege
ɨntseledʒetsj	înțelegeți
ɨntseleɡətor	înțelegător
ɨntselept	înțelept
ɨntsərka	înțărca
ɨʃj	își
ə	ă
ə	ă
əja	ăia
əl	ăl
əleja	ăleia
əlora	ălora
əluja	ăluia
əst	ăst
əstora	ăstora
əstuja	ăstuia
tse	ţ
ʃ	ș
ʃoldəneʃtj	șoldănești
ʃtefan	ștefan
ʃ	ș
ʃa	șa
ʃablon	șablon
ʃah	șah
ʃajbə	șaibă
ʃajsprezetʃe	șaisprezece
ʃajsprezetʃe̯a	șaisprezecea
ʃajsprezetʃele̯a	șaisprezecelea
ʃajsprezetʃime	șaisprezecime
ʃajzetʃe̯a	șaizecea
ʃajzetʃj	șaizeci
ʃajzetʃile̯a	șaizecilea
ʃajʃpe	șaișpe
ʃajʃpe̯a	șaișpea
ʃajʃpele̯a	șaișpelea
ʃal	șal
ʃamo̯a	șamoa
ʃampanie	șampanie
ʃapte	șapte
ʃapte̯a	șaptea
ʃaptele̯a	șaptelea
ʃaptesprezetʃe	șaptesprezece
ʃaptesprezetʃe̯a	șaptesprezecea
ʃaptesprezetʃele̯a	șaptesprezecelea
ʃaptezetʃe̯a	șaptezecea
ʃaptezetʃj	șaptezeci
ʃaptezetʃile̯a	șaptezecilea
ʃapteʃpe	șapteșpe
ʃapteʃpe̯a	șapteșpea
ʃapteʃpele̯a	șapteșpelea
ʃase	șase
ʃase̯a	șasea
ʃasele̯a	șaselea
ʃke̯au̯	șcheau
ʃcop	șchiop
ʃko̯alə	școală
ʃkolar	școlar
ʃede̯a	ședea
ʃedintsə	ședință
ʃefulikə	șefulică
ʃeptime	șeptime
ʃervet	șervet
ʃervete	șervete
ʃervetsel	șervețel
ʃervetsele	șervețele
ʃes	șes
ʃesime	șesime
ʃevalet	șevalet
ʃezut	șezut
ʃi	și
ʃiklu	șiclu
ʃiklurj	șicluri
ʃipok	șipoc
ʃireɡle	șiregle
ʃireɡlə	șireglă
ʃiret	șiret
ʃirezlə	șirezlă
ʃirə	șiră
ʃits	șiț
ʃle̯aw	șleau
ʃmeker	șmecher
ʃo̯aretʃe	șoarece
ʃobolan	șobolan
ʃojm	șoim
ʃontɨk	șontâc
ʃopɨrlə	șopârlă
ʃorikar	șoricar
ʃose̯a	șosea
ʃosele	șosele
ʃosetə	șosetă
ʃovəi	șovăi
ʃterpeli	șterpeli
ʃters	șters
ʃterʃj	șterși
ʃti	ști
ʃtiintsə	știință
ʃtirb	știrb
ʃtire	știre
ʃtjukə	știucă
ʃtiutor	știutor
ʃtrenɡar	ștrengar
ʃubred	șubred
ʃuɡui	șugui
ʃutitor	șutitor
ʃuvitsə	șuviță
ts	ț
ts	ț
tsaɡlə	țaglă
tsambal	țambal
tsandərə	țandără
tsar	țar
tsark	țarc
tsarinə	țarină
tsartsam	țarțam
tse̯apən	țeapăn
tse̯astə	țeastă
tseline	țeline
tselinə	țelină
tsesto̯asə	țestoasă
tsestos	țestos
tsiɡaje	țigaie
tsiɡan	țigan
tsiɡaŋkə	țigancă
tsiɡanj	țigani
tsiɡarə	țigară
tsiɡəne̯askə	țigănească
tsiɡənesk	țigănesc
tsiɡəneʃte	țigănește
tsiɡəneʃtj	țigănești
tsiɡəni	țigăni
tsiɡənie	țigănie
tsine	ține
tsinere	ținere
tsinerj	țineri
tsinut	ținut
tsipa	țipa
tsipar	țipar
tsitsej	țiței
tsujkə	țuică
tsurtsur	țurțur
tsɨntsar	țânțar
tsərankə	țărancă
tsərile	țările
tsərilor	țărilor
tsərɨnə	țărână
tsərəne̯askə	țărănească
tsərənesk	țărănesc
tsərəneʃte	țărănește
tsərəneʃtj	țărănești
tsərənoj	țărănoi
